일자,수량_공매도거래량_전체,수량_공매도거래량_업틱룰적용,수량_공매도거래량_업틱룰예외,수량_거래량,수량_비중,금액_공매도거래대금_전체,금액_공매도거래대금_업틱룰적용,금액_공매도거래대금_업틱룰예외,금액_거래대금,금액_비중
"2022/07/08","6477040","5974908","502132","108520280","5.97","347554995850","315119329025","32435666825","5481366254032","6.34"
"2022/07/07","6557780","5971850","585930","126308391","5.19","369638571755","343380649745","26257922010","6187396745597","5.97"
"2022/07/06","9067879","8053253","1014626","156255459","5.80","445951047935","397927365505","48023682430","7320258968101","6.09"
"2022/07/05","6776832","6269070","507762","110061662","6.16","363507952175","335108006455","28399945720","5593805878084","6.50"
"2022/07/04","8360134","7553174","806960","128355599","6.51","392785399900","347661722080","45123677820","5456744055406","7.20"
"2022/07/01","9204821","8340607","864214","136341014","6.75","485401180160","436340038755","49061141405","6640105588159","7.31"
"2022/06/30","8444970","7528549","916421","143728581","5.88","459440282955","399923505100","59516777855","6884662893235","6.67"
"2022/06/29","7713008","6941131","771877","132702473","5.81","453428992755","396231320935","57197671820","6316507805821","7.18"
"2022/06/28","6099938","5502768","597170","117270107","5.20","310377464250","279812930180","30564534070","5176514685988","6.00"
"2022/06/27","6047065","5454566","592499","136483261","4.43","277479790445","237784526925","39695263520","5923970339186","4.68"
"2022/06/24","8019254","7522383","496871","137827106","5.82","379001855140","352541514335","26460340805","6261623465471","6.05"
"2022/06/23","13742971","12870060","872911","197731766","6.95","584369546900","540333348660","44036198240","7893205010708","7.40"
"2022/06/22","11422837","10740426","682411","161699987","7.06","501532187905","464060514430","37471673475","6595752632164","7.60"
"2022/06/21","7632078","6996283","635795","120058757","6.36","352265274455","315702423480","36562850975","5524069194316","6.38"
"2022/06/20","10871272","9914306","956966","151134778","7.19","464942785535","418250116510","46692669025","6548982164978","7.10"
"2022/06/17","12634504","11538900","1095604","197274709","6.40","769635604090","711424085230","58211518860","8831028636019","8.72"
"2022/06/16","7698514","6757403","941111","138751851","5.55","388570956835","344457998555","44112958280","6833924982258","5.69"
"2022/06/15","10760572","9668319","1092253","159365415","6.75","508540174390","460626675725","47913498665","7401732983729","6.87"
"2022/06/14","12639074","11471441","1167633","174250564","7.25","569261293470","509247209025","60014084445","7468385969235","7.62"
"2022/06/13","12188064","10840813","1347251","163805809","7.44","586149511600","521026320940","65123190660","7193816119534","8.15"
"2022/06/10","11029344","9431056","1598288","136208016","8.10","570640688685","469309963570","101330725115","6290154321015","9.07"
"2022/06/09","15303808","11280366","4023442","191391854","8.00","763686508450","515093628505","248592879945","8507879984034","8.98"
"2022/06/08","8332010","7608889","723121","123302092","6.76","419538125195","367047336700","52490788495","6030965507002","6.96"
"2022/06/07","7303895","6546999","756896","135311555","5.40","347608931670","294487897165","53121034505","6687788632348","5.20"
"2022/06/03","7218523","6832547","385976","134646639","5.36","274267040250","247159129715","27107910535","4797509616342","5.72"
"2022/06/02","10970900","10231063","739837","196091386","5.59","488348853705","449329211760","39019641945","5908010491322","8.27"
"2022/05/31","11112188","10235776","876412","266678105","4.17","615334253910","573972702450","41361551460","11290597703804","5.45"
"2022/05/30","7655726","6928457","727269","151012831","5.07","378258982945","334292950500","43966032445","5604146609901","6.75"
"2022/05/27","6943965","6204782","739183","133072930","5.22","323649189705","286207191290","37441998415","5613542895753","5.77"
"2022/05/26","8597441","7880510","716931","126445367","6.80","414992853015","371256988320","43735864695","6231121581940","6.66"
"2022/05/25","10547003","9968488","578515","125139646","8.43","497406503880","465385887060","32020616820","5781990616472","8.60"
"2022/05/24","10266236","9533797","732439","150996891","6.80","406747622870","354730772525","52016850345","5827622859224","6.98"
"2022/05/23","8261171","7434235","826936","183164939","4.51","350013691705","307090762440","42922929265","5447158234709","6.43"
"2022/05/20","9217586","8313864","903722","133213782","6.92","405538648780","349976422480","55562226300","6183574152869","6.56"
"2022/05/19","14200543","12693811","1506732","196527465","7.23","511505498995","441127635745","70377863250","6861034807573","7.46"
"2022/05/18","11467680","10319965","1147715","166291214","6.90","470381573035","400725073650","69656499385","6302360001326","7.46"
"2022/05/17","13453214","12250509","1202705","171093883","7.86","502380266580","448627630630","53752635950","6087751077913","8.25"
"2022/05/16","11726028","10639849","1086179","231878012","5.06","453848427245","403298747340","50549679905","5375346947200","8.44"
"2022/05/13","15052468","13583895","1468573","187355684","8.03","605954662600","522668523260","83286139340","7012461396384","8.64"
"2022/05/12","17996094","15014732","2981362","262823514","6.85","755609322490","608705087265","146904235225","8649960825192","8.74"
"2022/05/11","12596823","10381480","2215343","184518723","6.83","512349266100","407133895185","105215370915","5952741363105","8.61"
"2022/05/10","14087783","13137155","950628","249371132","5.65","602999235045","550692979160","52306255885","7398734473921","8.15"
"2022/05/09","11997555","10760670","1236885","256536775","4.68","477591345855","397360854965","80230490890","5551146802828","8.60"
"2022/05/06","14420885","12798846","1622039","622950942","2.31","586637815830","498706865725","87930950105","7285813289921","8.05"
"2022/05/04","9356604","8513147","843457","279177321","3.35","380389519730","324678536615","55710983115","5532837523242","6.88"
"2022/05/03","7346277","6372816","973461","132700189","5.54","356964926745","298111000915","58853925830","5403829878955","6.61"
"2022/05/02","7579519","6768497","811022","131468536","5.77","401412505620","352156340915","49256164705","5220941142453","7.69"
"2022/04/29","9527686","8144090","1383596","182270799","5.23","450486683860","367077217270","83409466590","8028489423454","5.61"
"2022/04/28","13891712","11746447","2145265","164684493","8.44","607459971840","497365897850","110094073990","7241408296705","8.39"
"2022/04/27","11534038","10054138","1479900","146757175","7.86","502118514045","433516527190","68601986855","7409740037921","6.78"
"2022/04/26","7845966","6649494","1196472","122916877","6.38","484501611475","406881962430","77619649045","6485161212763","7.47"
"2022/04/25","11027438","9203256","1824182","139465955","7.91","552523100935","438181146920","114341954015","6608117568209","8.36"
"2022/04/22","11285484","9502217","1783267","214761534","5.25","525796128455","423242745345","102553383110","6159964465654","8.54"
"2022/04/21","7708902","7086473","622429","148564837","5.19","360967716120","323903915350","37063800770","6401492018994","5.64"
"2022/04/20","8153582","6632873","1520709","148872727","5.48","382015214800","300705984615","81309230185","6540303924225","5.84"
"2022/04/19","6435825","5525623","910202","130216350","4.94","281342328955","226282392095","55059936860","5195568464411","5.42"
"2022/04/18","7493145","5627462","1865683","110996402","6.75","325134667605","238445556320","86689111285","4519324381220","7.19"
"2022/04/15","8406022","6083843","2322179","142642668","5.89","405781917605","276125028885","129656888720","5821098591995","6.97"
"2022/04/14","9954722","8218008","1736714","159155308","6.25","497743263410","369912749345","127830514065","7211760259512","6.90"
"2022/04/13","8254206","7373902","880304","177428230","4.65","319504288290","274611465025","44892823265","6214853173731","5.14"
"2022/04/12","8490203","7536714","953489","129717478","6.55","406215411915","356395508920","49819902995","5816117786914","6.98"
"2022/04/11","8070709","7368402","702307","131522527","6.14","417065223795","373568750665","43496473130","5668333958425","7.36"
"2022/04/08","8562959","7596248","966711","166111896","5.15","429692792780","366898196230","62794596550","6737531401740","6.38"
"2022/04/07","13303059","11374365","1928694","193937391","6.86","565891081680","450723103325","115167978355","7704972240910","7.34"
"2022/04/06","9818095","8830692","987403","176510187","5.56","463662236850","392234980865","71427255985","6512785684822","7.12"
"2022/04/05","7562243","6793342","768901","244226348","3.10","308189044510","267693719965","40495324545","5262759081701","5.86"
"2022/04/04","5664989","5113318","551671","171554087","3.30","262781205925","228415292110","34365913815","5298139960894","4.96"
"2022/04/01","12821842","11959500","862342","446847689","2.87","380179227105","328916910815","51262316290","7196628144065","5.28"
"2022/03/31","10142246","9544385","597861","388609487","2.61","346851877340","309040802865","37811074475","6751915062603","5.14"
"2022/03/30","8151914","7179966","971948","141643855","5.76","370998292440","320567325700","50430966740","6530661073317","5.68"
"2022/03/29","8217204","7156080","1061124","132695450","6.19","342416815230","289814335445","52602479785","6170287309852","5.55"
"2022/03/28","8143948","6893646","1250302","136535025","5.96","382893552715","301609547765","81284004950","5890583769566","6.50"
"2022/03/25","7609961","6717457","892504","119074647","6.39","315249549735","248752833835","66496715900","6974694867070","4.52"
"2022/03/24","8162890","7342439","820451","149348495","5.47","359408054205","304559793015","54848261190","8556924147593","4.20"
"2022/03/23","8583453","7882240","701213","137431069","6.25","396666992210","344845129410","51821862800","7142403493714","5.55"
"2022/03/22","8529706","7767047","762659","120703024","7.07","389771750835","343151534225","46620216610","6949401916641","5.61"
"2022/03/21","7239935","6450110","789825","117142394","6.18","378297504980","314920885570","63376619410","6428429475390","5.88"
"2022/03/18","10042852","9200832","842020","155321051","6.47","489539414305","434285517810","55253896495","8266735365446","5.92"
"2022/03/17","10641247","9603434","1037813","172536469","6.17","448507546110","376457169155","72050376955","9185664503327","4.88"
"2022/03/16","9117813","8211265","906548","125092760","7.29","474120409700","422569800295","51550609405","6385893888137","7.42"
"2022/03/15","10699485","9152395","1547090","149108189","7.18","574518396335","506951250815","67567145520","7168563587586","8.01"
"2022/03/14","10279461","8870208","1409253","163912346","6.27","789243105065","693683826465","95559278600","8994583220022","8.77"
"2022/03/11","12577837","10792735","1785102","182548310","6.89","743414944714","632016023189","111398921525","9197993829492","8.08"
"2022/03/10","16979070","15558694","1420376","212652188","7.98","775007352663","693289007288","81718345375","10823571336089","7.16"
"2022/03/08","15280070","13553165","1726905","185897543","8.22","589435536525","485200726000","104234810525","8648190492065","6.82"
"2022/03/07","17963509","12231199","5732310","193155373","9.30","823090728379","461749788209","361340940170","8909049069354","9.24"
"2022/03/04","19679380","18554617","1124763","237190017","8.30","456509931060","386125157900","70384773160","8988126548763","5.08"
"2022/03/03","7737933","6930969","806964","167176676","4.63","330473474815","287428954405","43044520410","7323912860320","4.51"
"2022/03/02","9721450","8993465","727985","170944083","5.69","419496802820","383298063270","36198739550","7679437182276","5.46"
"2022/02/28","12390681","11048220","1342461","237317520","5.22","477723997615","419899582160","57824415455","9445530427483","5.06"
"2022/02/25","8497243","7803535","693708","154972994","5.48","401512538030","364440878955","37071659075","7423040569800","5.41"
"2022/02/24","8904392","7695174","1209218","167277164","5.32","493457608935","423543119410","69914489525","8503343379721","5.80"
"2022/02/23","8444136","7715302","728834","139928097","6.03","377565504215","349256342030","28309162185","6112151593830","6.18"
"2022/02/22","8923771","7997127","926644","162875958","5.48","409981520560","363587646015","46393874545","6905186484439","5.94"
"2022/02/21","5069747","4351017","718730","109544039","4.63","279398884535","245787685910","33611198625","5668991436860","4.93"
"2022/02/18","8940902","7870677","1070225","137053118","6.52","371457064545","330163979735","41293084810","6082517288286","6.11"
"2022/02/17","7529368","6212919","1316449","209730967","3.59","390392581420","318672578725","71720002695","8637742117822","4.52"
"2022/02/16","7583492","6674876","908616","108436280","6.99","401824328180","358380665885","43443662295","5968406412135","6.73"
"2022/02/15","8948336","7847511","1100825","140833154","6.35","421006625995","368574026130","52432599865","6638804691530","6.34"
"2022/02/14","10596661","9311935","1284726","146971729","7.21","443921567310","375670919940","68250647370","6963340040466","6.38"
"2022/02/11","11875268","9573486","2301782","161469119","7.35","672233524460","553143398315","119090126145","8189120219283","8.21"
"2022/02/10","13331649","11040975","2290674","180487876","7.39","673640476580","579917818805","93722657775","9052187214238","7.44"
"2022/02/09","8769362","8232274","537088","117910162","7.44","447408390640","420343949245","27064441395","6516035422387","6.87"
"2022/02/08","9644042","8936079","707963","133105733","7.25","535243665074","488966759434","46276905640","7590982301469","7.05"
"2022/02/07","8519722","7230672","1289050","135534006","6.29","471578396380","409820740355","61757656025","7200575552875","6.55"
"2022/02/04","6722563","5843036","879527","109788153","6.12","372569100510","343199184410","29369916100","6431976708608","5.79"
"2022/02/03","7896401","7200851","695550","125482179","6.29","513961134195","451725143775","62235990420","7863881143246","6.54"
"2022/01/28","10967538","10028756","938782","146975846","7.46","652899794630","594643372005","58256422625","9427049699831","6.93"
"2022/01/27","11944788","11050314","894474","158318286","7.54","703820155155","638594969720","65225185435","9998445147336","7.04"
"2022/01/26","7893177","7035340","857837","109342528","7.22","463645101650","426302250615","37342851035","6781554969243","6.84"
"2022/01/25","9717367","8934424","782943","142181165","6.83","566571946705","501617085165","64954861540","8369863265110","6.77"
"2022/01/24","7167328","6395660","771668","112639984","6.36","442361330295","403000153345","39361176950","6718747948400","6.58"
"2022/01/21","8212652","6991099","1221553","134237431","6.12","502654509085","433361122500","69293386585","8074616042698","6.23"
"2022/01/20","8391087","7353662","1037425","114098651","7.35","439887888370","403544578075","36343310295","6960681998037","6.32"
"2022/01/19","11494442","9978604","1515838","126170181","9.11","593203728380","514841324380","78362404000","7634913768260","7.77"
"2022/01/18","10688067","9027948","1660119","127939028","8.35","557702137215","496472873535","61229263680","7234303513263","7.71"
"2022/01/17","10927279","8949468","1977811","135817575","8.05","607447777369","516758044859","90689732510","7413658579965","8.19"
"2022/01/14","13069741","10689771","2379970","146048033","8.95","656559811538","532402543173","124157268365","8539783273232","7.69"
"2022/01/13","10619449","8134063","2485386","151714327","7.00","617252912665","477051235320","140201677345","8899436063624","6.94"
"2022/01/12","8986534","7575420","1411114","210105987","4.28","559955907795","479773955135","80181952660","8821315438186","6.35"
"2022/01/11","9331440","8065498","1265942","133428702","6.99","513353086255","413355067295","99998018960","7933719172030","6.47"
"2022/01/10","10294034","8640239","1653795","139103010","7.40","690050948075","531479838950","158571109125","8306218369388","8.31"
"2022/01/07","7290295","5754417","1535878","114276571","6.38","677990105250","555556033060","122434072190","8111558464898","8.36"
"2022/01/06","10399712","8438223","1961489","152386576","6.82","679283653035","542435968020","136847685015","9949712804745","6.83"
"2022/01/05","12535522","8293876","4241646","175488530","7.14","766880195135","480885604745","285994590390","11706291914065","6.55"
"2022/01/04","7393525","5880214","1513311","117160885","6.31","444300000830","345241352795","99058648035","7335075222470","6.06"
"2022/01/03","5412406","4163970","1248436","97581473","5.55","320450211245","253396399165","67053812080","5916887559115","5.42"