일자,기관,개인,외국인,기타,전체
"2022/07/08","1562280","189202","4866484","0","6617966"
"2022/07/07","1248678","264438","5128021","0","6641137"
"2022/07/06","2330470","282583","6558387","0","9171440"
"2022/07/05","1066003","247738","5541978","432","6856151"
"2022/07/04","2117203","243745","6196109","0","8557057"
"2022/07/01","2309644","327677","6661527","27","9298875"
"2022/06/30","3092629","291475","5275850","0","8659954"
"2022/06/29","2506120","258595","5120394","0","7885109"
"2022/06/28","1673700","147398","4386009","0","6207107"
"2022/06/27","1425209","169282","4771061","0","6365552"
"2022/06/24","1032509","229616","6908095","0","8170220"
"2022/06/23","2578755","380288","11086748","0","14045791"
"2022/06/22","2099246","264055","9280423","0","11643724"
"2022/06/21","1575773","259091","6032244","0","7867108"
"2022/06/20","2339650","243098","8793054","0","11375802"
"2022/06/17","2877442","260072","9775945","0","12913459"
"2022/06/16","1919058","185973","5793801","0","7898832"
"2022/06/15","2239540","212601","8553686","3000","11008827"
"2022/06/14","2288505","477501","10026469","0","12792475"
"2022/06/13","3365027","111651","8843741","0","12320419"
"2022/06/10","3617183","161330","7366788","0","11145301"
"2022/06/09","3637080","201094","11748892","0","15587066"
"2022/06/08","1499339","178844","6705317","0","8383500"
"2022/06/07","1577427","256500","5524670","0","7358597"
"2022/06/03","1276973","102403","5895048","0","7274424"
"2022/06/02","1346907","409278","9272285","0","11028470"
"2022/05/31","1785899","292691","9174136","0","11252726"
"2022/05/30","1221866","212159","6270816","0","7704841"
"2022/05/27","1175825","195432","5610456","0","6981713"
"2022/05/26","1647533","174816","6843140","0","8665489"
"2022/05/25","1616366","151740","8863772","0","10631878"
"2022/05/24","1521109","177397","8614610","0","10313116"
"2022/05/23","1323914","218287","6791117","0","8333318"
"2022/05/20","1538009","101700","7849532","0","9489241"
"2022/05/19","3618166","483795","10143610","0","14245571"
"2022/05/18","2015396","133700","9369248","0","11518344"
"2022/05/17","2419452","355120","10754675","0","13529247"
"2022/05/16","2010935","628519","9142920","0","11782374"
"2022/05/13","2209070","396380","12540101","0","15145551"
"2022/05/12","5528833","789554","11790781","0","18109168"
"2022/05/11","3716137","295669","8634927","0","12646733"
"2022/05/10","2792528","267532","11197707","0","14257767"
"2022/05/09","2770968","121781","9177679","0","12070428"
"2022/05/06","4142421","801910","9595595","0","14539926"
"2022/05/04","1570424","854954","6997562","0","9422940"
"2022/05/03","1603763","127523","5672603","0","7403889"
"2022/05/02","2081957","194991","5368645","0","7645593"
"2022/04/29","1983780","155520","7473877","0","9613177"
"2022/04/28","2727925","277250","10958955","0","13964130"
"2022/04/27","2381761","192294","9022537","0","11596592"
"2022/04/26","2008277","106047","5758058","0","7872382"
"2022/04/25","3381521","150918","7585493","0","11117932"
"2022/04/22","3129540","725449","7807061","0","11662050"
"2022/04/21","1444609","159799","6156886","0","7761294"
"2022/04/20","2211082","101574","5906010","0","8218666"
"2022/04/19","1500299","142578","4867586","0","6510463"
"2022/04/18","2607910","108108","4869375","0","7585393"
"2022/04/15","3289502","138946","5144867","0","8573315"
"2022/04/14","2865368","265680","6909387","0","10040435"
"2022/04/13","1580054","308770","6432256","0","8321080"
"2022/04/12","2268247","95561","6260325","0","8624133"
"2022/04/11","1927745","130395","6052212","0","8110352"
"2022/04/08","1970158","115171","6548159","0","8633488"
"2022/04/07","3415624","153064","9804435","0","13373123"
"2022/04/06","2506136","145927","7242501","0","9894564"
"2022/04/05","1700767","414902","5551752","0","7667421"
"2022/04/04","1466915","87136","4200793","0","5754844"
"2022/04/01","2026043","304934","10611820","0","12942797"
"2022/03/31","3109233","597121","6548855","0","10255209"
"2022/03/30","2889642","119460","5246406","0","8255508"
"2022/03/29","2574655","188561","5632524","0","8395740"
"2022/03/28","2679588","147670","5432778","0","8260036"
"2022/03/25","2836655","173407","4652250","0","7662312"
"2022/03/24","2519891","245679","5515336","0","8280906"
"2022/03/23","2296973","176730","6238191","323","8712217"
"2022/03/22","2686862","149384","5849173","0","8685419"
"2022/03/21","2875661","120767","4284681","14","7281123"
"2022/03/18","1948807","181293","8063205","0","10193305"
"2022/03/17","4389206","165668","6211625","150000","10916499"
"2022/03/16","2644605","234339","6354982","0","9233926"
"2022/03/15","3419503","204577","7188787","0","10812867"
"2022/03/14","2716425","298568","7325447","0","10340440"
"2022/03/11","5016863","369206","7250441","0","12636510"
"2022/03/10","3670161","431590","12993005","0","17094756"
"2022/03/08","6599257","399974","8326733","0","15325964"
"2022/03/07","7472631","325031","10200865","0","17998527"
"2022/03/04","11360790","553168","7829420","0","19743378"
"2022/03/03","2007641","354261","5496337","0","7858239"
"2022/03/02","1805003","223038","7738724","0","9766765"
"2022/02/28","4082103","263043","8114214","260","12459620"
"2022/02/25","1876519","308221","6380421","110","8565271"
"2022/02/24","2405093","274085","6263071","0","8942249"
"2022/02/23","1893618","311444","6280567","243","8485872"
"2022/02/22","1781869","320170","6857464","0","8959503"
"2022/02/21","1379340","176333","3581873","1169","5138715"
"2022/02/18","2661756","368845","5954575","1","8985177"
"2022/02/17","2739719","370754","4588832","280","7699585"
"2022/02/16","2068278","206752","5449757","0","7724787"
"2022/02/15","2901214","369401","5728289","0","8998904"
"2022/02/14","4078062","313142","6319654","0","10710858"
"2022/02/11","3983059","203956","7981824","0","12168839"
"2022/02/10","5146025","603897","7677641","0","13427563"
"2022/02/09","2202544","136100","6544478","0","8883122"
"2022/02/08","3344242","175332","6233121","139","9752834"
"2022/02/07","2584610","143320","5855567","92","8583589"
"2022/02/04","1558053","174937","5088884","0","6821874"
"2022/02/03","1354580","140309","6450931","0","7945820"
"2022/01/28","1824855","212239","9054794","0","11091888"
"2022/01/27","1625659","173017","10252430","0","12051106"
"2022/01/26","1477422","157457","6388142","9","8023030"
"2022/01/25","1554220","137285","8130346","0","9821851"
"2022/01/24","1383708","119224","5825696","0","7328628"
"2022/01/21","2036705","250722","5990079","0","8277506"
"2022/01/20","1957174","157050","6349201","0","8463425"
"2022/01/19","3225050","156467","8349429","0","11730946"
"2022/01/18","2875092","148480","7707941","0","10731513"
"2022/01/17","3319658","204236","7542909","0","11066803"
"2022/01/14","3784918","327472","9095305","0","13207695"
"2022/01/13","4713544","196313","5906249","0","10816106"
"2022/01/12","2609043","389685","6160097","0","9158825"
"2022/01/11","2824426","202201","6445624","0","9472251"
"2022/01/10","2742255","171186","7519728","0","10433169"
"2022/01/07","2491581","79930","5164328","0","7735839"
"2022/01/06","3225090","159279","7237154","200","10621723"
"2022/01/05","5366761","141878","7097082","0","12605721"
"2022/01/04","2385815","99628","5015767","0","7501210"
"2022/01/03","2189904","71409","3415901","0","5677214"
"2021/12/30","1103917","43866","3491129","0","4638912"
"2021/12/29","2214611","182231","5749020","130","8145992"
"2021/12/28","1173349","204482","3991489","0","5369320"
"2021/12/27","1102340","61965","2266595","0","3430900"
"2021/12/24","580097","47120","2481353","0","3108570"
"2021/12/23","916989","70797","3847645","0","4835431"
"2021/12/22","931550","80148","3707980","0","4719678"
"2021/12/21","1752429","94977","4212071","0","6059477"
"2021/12/20","1566273","102326","4337766","0","6006365"
"2021/12/17","1278391","103826","5823054","0","7205271"
"2021/12/16","1603083","75198","3324750","0","5003031"
"2021/12/15","1867361","79335","3272077","0","5218773"
"2021/12/14","1389772","90623","4201825","50","5682270"
"2021/12/13","1150367","79664","3622136","0","4852167"
"2021/12/10","1799584","159513","3294300","7864","5261261"
"2021/12/09","3128542","139677","8766357","0","12034576"
"2021/12/08","1368518","108729","5025914","14718","6517879"
"2021/12/07","2380509","244897","5233229","5282","7863917"
"2021/12/06","1108150","94374","4245410","20000","5467934"
"2021/12/03","1112993","100699","5095529","0","6309221"
"2021/12/02","998337","135101","5818272","0","6951710"
"2021/12/01","1134595","183346","5846802","0","7164743"
"2021/11/30","2011257","224285","12801689","0","15037231"
"2021/11/29","1400129","145913","7444605","0","8990647"
"2021/11/26","1684177","71740","5225890","0","6981807"
"2021/11/25","705251","72379","5224367","0","6001997"
"2021/11/24","1197680","74933","5061458","0","6334071"
"2021/11/23","1311921","92349","5887785","0","7292055"
"2021/11/22","1928333","81657","6234464","0","8244454"
"2021/11/19","849843","79383","6357766","0","7286992"
"2021/11/18","1068399","217464","5233890","0","6519753"
"2021/11/17","2328340","143313","6761051","0","9232704"
"2021/11/16","1241217","122750","6675311","0","8039278"
"2021/11/15","1439158","146850","7363500","0","8949508"
"2021/11/12","1598376","179438","7293766","0","9071580"
"2021/11/11","1528076","125503","7044638","0","8698217"
"2021/11/10","707027","122866","6036860","0","6866753"
"2021/11/09","1620486","65339","5665902","0","7351727"
"2021/11/08","1530879","118940","5437821","0","7087640"
"2021/11/05","1531240","232804","6793965","0","8558009"
"2021/11/04","1426849","187236","6501807","0","8115892"
"2021/11/03","1081285","168916","9080481","0","10330682"
"2021/11/02","972510","89920","4229152","0","5291582"
"2021/11/01","986050","136518","5766990","1513","6891071"
"2021/10/29","1442081","136584","6466856","0","8045521"
"2021/10/28","1790990","166010","6815586","0","8772586"
"2021/10/27","3725380","241385","8198505","14000","12179270"
"2021/10/26","1566302","119770","6089992","0","7776064"
"2021/10/25","1931636","219513","4592896","0","6744045"
"2021/10/22","1022677","111715","4270295","0","5404687"
"2021/10/21","928883","163908","5661852","0","6754643"
"2021/10/20","1814048","117796","6708984","0","8640828"
"2021/10/19","1487949","119228","4553345","0","6160522"
"2021/10/18","2098091","123122","4512545","0","6733758"
"2021/10/15","2049391","167664","7075330","0","9292385"
"2021/10/14","2178073","265611","8464061","0","10907745"
"2021/10/13","1570192","174226","7137757","0","8882175"
"2021/10/12","1656827","186561","7861887","0","9705275"
"2021/10/08","1781283","186686","7296665","0","9264634"
"2021/10/07","1372574","225641","7020643","0","8618858"
"2021/10/06","1710676","178769","9140120","84","11029649"
"2021/10/05","2004365","227476","9962857","0","12194698"
"2021/10/01","2746835","187569","7581275","0","10515679"
"2021/09/30","2501271","236811","8223215","0","10961297"
"2021/09/29","2470191","148411","6020160","0","8638762"
"2021/09/28","2183914","151835","4514782","5000","6855531"
"2021/09/27","1291357","122875","4264718","0","5678950"
"2021/09/24","1201045","109561","6636611","0","7947217"
"2021/09/23","1148700","153014","6483443","2","7785159"
"2021/09/17","1517716","138770","9008626","2","10665114"
"2021/09/16","1222408","156827","8379715","5","9758955"
"2021/09/15","1754861","127153","6463164","5","8345183"
"2021/09/14","1281582","89602","5559164","10","6930358"
"2021/09/13","1362457","141824","5547252","0","7051533"
"2021/09/10","1988441","115615","6469142","31","8573229"
"2021/09/09","2401295","114108","7509391","0","10024794"
"2021/09/08","1584806","174874","6388447","8","8148135"
"2021/09/07","1711854","98339","4752310","0","6562503"
"2021/09/06","875168","86158","4957888","0","5919214"
"2021/09/03","1002302","76742","6503790","15","7582849"
"2021/09/02","1164583","180961","5483258","0","6828802"
"2021/09/01","1689400","125015","5486741","0","7301156"
"2021/08/31","1402137","116801","5965008","0","7483946"
"2021/08/30","1311474","133280","4264539","15","5709308"
"2021/08/27","866495","165483","4228042","0","5260020"
"2021/08/26","1411114","181157","6876317","0","8468588"
"2021/08/25","1177930","240605","6240879","0","7659414"
"2021/08/24","1077310","152409","7048264","30","8278013"
"2021/08/23","1322611","167225","7839711","0","9329547"
"2021/08/20","1732569","226940","8750735","45","10710289"
"2021/08/19","1373460","158339","6672437","0","8204236"
"2021/08/18","976414","275831","5090047","0","6342292"
"2021/08/17","1511571","146429","5380838","10","7038848"
"2021/08/13","1403580","86989","8168546","0","9659115"
"2021/08/12","1822004","211609","7737549","0","9771162"
"2021/08/11","1189596","101251","5373012","0","6663859"
"2021/08/10","2258413","237415","4899641","0","7395469"
"2021/08/09","2046064","123888","4511372","0","6681324"
"2021/08/06","855579","100600","6399350","0","7355529"
"2021/08/05","1006536","216389","3983512","0","5206437"
"2021/08/04","969064","159405","4571134","0","5699603"
"2021/08/03","883541","121905","4755161","20","5760627"
"2021/08/02","910129","115312","4702556","0","5727997"
"2021/07/30","1045967","138551","5310178","0","6494696"
"2021/07/29","891354","145473","4715733","0","5752560"
"2021/07/28","649317","140464","5395827","0","6185608"
"2021/07/27","871864","95867","5305892","0","6273623"
"2021/07/26","882142","118417","4456383","0","5456942"
"2021/07/23","1429135","137823","5073723","0","6640681"
"2021/07/22","1392077","149129","5730906","0","7272112"
"2021/07/21","3427195","183540","5825438","0","9436173"
"2021/07/20","2344989","141937","5612774","0","8099700"
"2021/07/19","1646264","102016","4187671","0","5935951"
"2021/07/16","1797473","81705","5179010","100","7058288"
"2021/07/15","1753322","106252","5200937","0","7060511"
"2021/07/14","1366747","113121","5705962","0","7185830"
"2021/07/13","1073484","141527","5600618","0","6815629"
"2021/07/12","1194594","124434","4775357","0","6094385"
"2021/07/09","3027598","220705","7043932","0","10292235"
"2021/07/08","1268517","158372","6634193","0","8061082"
"2021/07/07","1293532","147200","5145402","0","6586134"
"2021/07/06","1341993","173494","4237084","0","5752571"
"2021/07/05","1008294","113959","4054351","0","5176604"
"2021/07/02","1075744","124249","4528448","0","5728441"
"2021/07/01","1737095","131220","5036632","0","6904947"
"2021/06/30","1784721","99149","5392787","0","7276657"
"2021/06/29","1939333","197042","5080185","0","7216560"
"2021/06/28","3101473","224749","5254902","0","8581124"
"2021/06/25","3013386","250294","5743406","0","9007086"
"2021/06/24","2890090","195945","6620820","0","9706855"
"2021/06/23","1883770","151051","8408616","539","10443976"
"2021/06/22","2553186","251198","5995015","0","8799399"
"2021/06/21","2891561","97852","6515319","0","9504732"
"2021/06/18","1889051","122834","5850054","0","7861939"
"2021/06/17","3045125","132200","6024725","0","9202050"
"2021/06/16","2161624","130603","4684620","0","6976847"
"2021/06/15","1946962","151872","7092326","0","9191160"
"2021/06/14","1946807","139652","4336893","590","6423942"
"2021/06/11","4728393","214174","9239586","2650","14184803"
"2021/06/10","2973341","216151","8787879","0","11977371"
"2021/06/09","2797117","219124","6117397","1772","9135410"
"2021/06/08","2874606","338591","7134204","0","10347401"
"2021/06/07","4202934","302894","6554491","3043","11063362"
"2021/06/04","4739309","390923","6646572","0","11776804"
"2021/06/03","2534265","152762","6626513","0","9313540"
"2021/06/02","4096736","361465","7751975","0","12210176"
"2021/06/01","2590097","195406","7486746","1875","10274124"
"2021/05/31","3290572","120884","7600908","5566","11017930"
"2021/05/28","2555207","138423","8767364","238","11461232"
"2021/05/27","1968474","157436","11284269","0","13410179"
"2021/05/26","1840428","155151","8219771","0","10215350"
"2021/05/25","1154482","148938","8080171","356","9383947"
"2021/05/24","2216495","155880","8189127","275","10561777"
"2021/05/21","1896647","206722","9516865","744","11620978"
"2021/05/20","1964446","174663","10001265","0","12140374"
"2021/05/18","1094224","178865","8628896","0","9901985"
"2021/05/17","3556689","167429","8252812","0","11976930"
"2021/05/14","1417929","250070","7451103","18","9119120"
"2021/05/13","2176464","429406","12627022","9983","15242875"
"2021/05/12","1645235","268447","14784120","460","16698262"
"2021/05/11","2161718","395383","11465234","640","14022975"
"2021/05/10","1378305","221887","9488399","15","11088606"
"2021/05/07","1034910","196221","8423186","5","9654322"
"2021/05/06","1013653","416777","16344339","0","17774769"
"2021/05/04","2810417","221346","13618567","0","16650330"
"2021/05/03","1809717","252235","18604423","0","20666375"
"2021/04/30","351441","0","0","0","351441"
"2021/04/29","228868","0","0","0","228868"
"2021/04/28","509498","0","0","0","509498"
"2021/04/27","370464","0","0","0","370464"
"2021/04/26","583242","0","0","0","583242"
"2021/04/23","181508","0","0","0","181508"
"2021/04/22","207794","0","0","0","207794"
"2021/04/21","380796","0","0","0","380796"
"2021/04/20","253187","0","0","0","253187"
"2021/04/19","227772","0","0","0","227772"
"2021/04/16","213196","0","0","0","213196"
"2021/04/15","300212","0","0","0","300212"
"2021/04/14","169995","0","0","0","169995"
"2021/04/13","228910","0","0","0","228910"
"2021/04/12","153331","0","0","0","153331"
"2021/04/09","396881","0","0","0","396881"
"2021/04/08","385763","0","0","0","385763"
"2021/04/07","563801","0","0","0","563801"
"2021/04/06","451967","0","0","0","451967"
"2021/04/05","154686","0","0","0","154686"
"2021/04/02","335658","0","0","0","335658"
"2021/04/01","349068","0","0","0","349068"
"2021/03/31","459925","0","0","0","459925"
"2021/03/30","419279","0","0","0","419279"
"2021/03/29","603578","0","0","0","603578"
"2021/03/26","499404","0","0","0","499404"
"2021/03/25","295101","0","0","0","295101"
"2021/03/24","261671","0","0","0","261671"
"2021/03/23","321193","0","0","0","321193"
"2021/03/22","302413","0","0","0","302413"
"2021/03/19","561017","0","0","0","561017"
"2021/03/18","193912","0","0","0","193912"
"2021/03/17","395075","0","0","0","395075"
"2021/03/16","139905","0","0","0","139905"
"2021/03/15","438924","0","0","0","438924"
"2021/03/12","362968","0","0","0","362968"
"2021/03/11","507366","0","0","0","507366"
"2021/03/10","152694","0","0","0","152694"
"2021/03/09","292500","0","0","0","292500"
"2021/03/08","267784","0","0","0","267784"
"2021/03/05","783068","0","0","0","783068"
"2021/03/04","405424","0","0","0","405424"
"2021/03/03","178758","0","0","0","178758"
"2021/03/02","265320","0","0","0","265320"
"2021/02/26","394665","0","0","0","394665"
"2021/02/25","168663","0","0","0","168663"
"2021/02/24","200525","0","0","0","200525"
"2021/02/23","202730","0","0","0","202730"
"2021/02/22","291904","0","0","0","291904"
"2021/02/19","335981","0","0","0","335981"
"2021/02/18","292620","0","0","0","292620"
"2021/02/17","314095","0","0","0","314095"
"2021/02/16","246117","0","0","0","246117"
"2021/02/15","147786","0","0","0","147786"
"2021/02/10","178700","0","0","0","178700"
"2021/02/09","225194","0","0","0","225194"
"2021/02/08","340892","0","0","0","340892"
"2021/02/05","246024","0","0","0","246024"
"2021/02/04","310114","0","0","0","310114"
"2021/02/03","157068","0","0","0","157068"
"2021/02/02","283023","0","0","0","283023"
"2021/02/01","504208","0","0","0","504208"
"2021/01/29","527219","0","0","0","527219"
"2021/01/28","408576","0","0","0","408576"
"2021/01/27","399172","0","0","0","399172"
"2021/01/26","478268","0","0","0","478268"
"2021/01/25","303055","0","0","0","303055"
"2021/01/22","356044","0","0","0","356044"
"2021/01/21","422529","0","0","0","422529"
"2021/01/20","206970","0","0","0","206970"
"2021/01/19","454318","0","0","0","454318"
"2021/01/18","372179","0","0","0","372179"
"2021/01/15","487853","0","0","0","487853"
"2021/01/14","457320","0","0","0","457320"
"2021/01/13","301912","0","0","0","301912"
"2021/01/12","455149","0","0","0","455149"
"2021/01/11","325955","0","0","0","325955"
"2021/01/08","525053","0","0","0","525053"
"2021/01/07","510984","0","0","0","510984"
"2021/01/06","437326","0","0","0","437326"
"2021/01/05","612363","0","0","0","612363"
"2021/01/04","522089","0","0","0","522089"
"2020/12/30","487505","0","0","0","487505"
"2020/12/29","248107","0","0","0","248107"
"2020/12/28","478551","0","0","0","478551"
"2020/12/24","311483","0","0","0","311483"
"2020/12/23","359434","0","0","0","359434"
"2020/12/22","273733","0","0","0","273733"
"2020/12/21","258787","0","0","0","258787"
"2020/12/18","239529","0","0","0","239529"
"2020/12/17","296164","0","0","0","296164"
"2020/12/16","479661","0","0","0","479661"
"2020/12/15","461462","0","0","0","461462"
"2020/12/14","504420","0","0","0","504420"
"2020/12/11","1093637","0","0","0","1093637"
"2020/12/10","1298811","0","0","0","1298811"
"2020/12/09","208160","0","0","0","208160"
"2020/12/08","254430","0","0","0","254430"
"2020/12/07","263868","0","0","0","263868"
"2020/12/04","406036","0","0","0","406036"
"2020/12/03","189108","0","0","0","189108"
"2020/12/02","290819","0","0","0","290819"
"2020/12/01","306253","0","0","0","306253"
"2020/11/30","548202","0","0","0","548202"
"2020/11/27","384853","0","0","0","384853"
"2020/11/26","447976","0","0","0","447976"
"2020/11/25","424238","0","0","0","424238"
"2020/11/24","542094","0","0","0","542094"
"2020/11/23","775653","0","0","0","775653"
"2020/11/20","289297","0","0","0","289297"
"2020/11/19","271064","0","0","0","271064"
"2020/11/18","308182","0","0","0","308182"
"2020/11/17","265910","0","0","0","265910"
"2020/11/16","416669","0","0","0","416669"
"2020/11/13","196143","0","0","0","196143"
"2020/11/12","330763","0","0","0","330763"
"2020/11/11","314408","0","0","0","314408"
"2020/11/10","234067","0","0","0","234067"
"2020/11/09","462310","0","0","0","462310"
"2020/11/06","182493","0","0","0","182493"
"2020/11/05","185558","0","0","0","185558"
"2020/11/04","290079","0","0","0","290079"
"2020/11/03","211824","0","0","0","211824"
"2020/11/02","80821","0","0","0","80821"
"2020/10/30","210796","0","0","0","210796"
"2020/10/29","138110","0","0","0","138110"
"2020/10/28","86391","0","0","0","86391"
"2020/10/27","142508","0","0","0","142508"
"2020/10/26","188765","0","0","0","188765"
"2020/10/23","232018","0","0","0","232018"
"2020/10/22","186146","0","0","0","186146"
"2020/10/21","241417","0","0","0","241417"
"2020/10/20","245619","0","0","0","245619"
"2020/10/19","265889","0","0","0","265889"
"2020/10/16","137800","0","0","0","137800"
"2020/10/15","215866","0","0","0","215866"
"2020/10/14","178251","0","0","0","178251"
"2020/10/13","138978","0","0","0","138978"
"2020/10/12","320045","0","0","0","320045"
"2020/10/08","417097","0","0","0","417097"
"2020/10/07","131969","0","0","0","131969"
"2020/10/06","101565","0","0","0","101565"
"2020/10/05","209100","0","0","0","209100"
"2020/09/29","391012","0","0","0","391012"
"2020/09/28","573719","0","0","0","573719"
"2020/09/25","414035","0","0","0","414035"
"2020/09/24","265782","0","0","0","265782"
"2020/09/23","355423","0","0","0","355423"
"2020/09/22","911289","0","0","0","911289"
"2020/09/21","280964","0","0","0","280964"
"2020/09/18","170801","0","0","0","170801"
"2020/09/17","198400","0","0","0","198400"
"2020/09/16","290085","0","0","0","290085"
"2020/09/15","281788","0","0","0","281788"
"2020/09/14","396411","0","0","0","396411"
"2020/09/11","465564","0","0","0","465564"
"2020/09/10","782465","0","0","0","782465"
"2020/09/09","264381","0","0","0","264381"
"2020/09/08","389648","0","0","0","389648"
"2020/09/07","293705","0","0","0","293705"
"2020/09/04","984283","0","0","0","984283"
"2020/09/03","761765","0","0","0","761765"
"2020/09/02","902282","0","0","0","902282"
"2020/09/01","423579","0","0","0","423579"
"2020/08/31","690469","0","0","0","690469"
"2020/08/28","532327","0","0","0","532327"
"2020/08/27","168124","0","0","0","168124"
"2020/08/26","142460","0","0","0","142460"
"2020/08/25","239365","0","0","0","239365"
"2020/08/24","254450","0","0","0","254450"
"2020/08/21","285342","0","0","0","285342"
"2020/08/20","483469","0","0","0","483469"
"2020/08/19","286022","0","0","0","286022"
"2020/08/18","281116","0","0","0","281116"
"2020/08/14","408588","0","0","0","408588"
"2020/08/13","323119","0","0","0","323119"
"2020/08/12","414720","0","0","0","414720"
"2020/08/11","365145","0","0","0","365145"
"2020/08/10","369833","0","0","0","369833"
"2020/08/07","680300","0","0","0","680300"
"2020/08/06","372487","0","0","0","372487"
"2020/08/05","405855","0","0","0","405855"
"2020/08/04","390563","0","0","0","390563"
"2020/08/03","366296","0","0","0","366296"
"2020/07/31","219896","0","0","0","219896"
"2020/07/30","300008","0","0","0","300008"
"2020/07/29","411431","0","0","0","411431"
"2020/07/28","204210","0","0","0","204210"
"2020/07/27","435722","0","0","0","435722"
"2020/07/24","620692","0","0","0","620692"
"2020/07/23","439268","0","0","0","439268"
"2020/07/22","1150693","0","0","0","1150693"
"2020/07/21","1109730","0","0","0","1109730"
"2020/07/20","337879","0","0","0","337879"
"2020/07/17","324913","0","0","0","324913"
"2020/07/16","224355","0","0","0","224355"
"2020/07/15","277684","0","0","0","277684"
"2020/07/14","239617","0","0","0","239617"
"2020/07/13","261605","0","0","0","261605"
"2020/07/10","452223","0","0","0","452223"
"2020/07/09","292363","0","0","0","292363"
"2020/07/08","304028","0","0","0","304028"
"2020/07/07","227841","0","0","0","227841"
"2020/07/06","227736","0","0","0","227736"
"2020/07/03","165148","0","0","0","165148"
"2020/07/02","224949","0","0","0","224949"
"2020/07/01","223453","0","0","0","223453"
"2020/06/30","671928","0","0","0","671928"
"2020/06/29","301556","0","0","0","301556"
"2020/06/26","227181","0","0","0","227181"
"2020/06/25","331947","0","0","0","331947"
"2020/06/24","305288","0","0","0","305288"
"2020/06/23","274869","0","0","0","274869"
"2020/06/22","386438","0","0","0","386438"
"2020/06/19","520078","0","0","0","520078"
"2020/06/18","549705","0","0","0","549705"
"2020/06/17","1505915","0","0","0","1505915"
"2020/06/16","1265609","0","0","0","1265609"
"2020/06/15","627832","0","0","0","627832"
"2020/06/12","1795953","0","0","0","1795953"
"2020/06/11","2989381","0","0","0","2989381"
"2020/06/10","353229","0","0","0","353229"
"2020/06/09","384705","0","0","0","384705"
"2020/06/08","273993","0","0","0","273993"
"2020/06/05","436596","0","0","0","436596"
"2020/06/04","959667","0","0","0","959667"
"2020/06/03","873546","0","0","0","873546"
"2020/06/02","645007","0","0","0","645007"
"2020/06/01","432401","0","0","0","432401"
"2020/05/29","724117","0","0","0","724117"
"2020/05/28","258897","0","0","0","258897"
"2020/05/27","290051","0","0","0","290051"
"2020/05/26","193822","0","0","0","193822"
"2020/05/25","275097","0","0","0","275097"
"2020/05/22","522475","0","0","0","522475"
"2020/05/21","466411","0","0","0","466411"
"2020/05/20","296946","0","0","0","296946"
"2020/05/19","458992","0","0","0","458992"
"2020/05/18","344036","0","0","0","344036"
"2020/05/15","451733","0","0","0","451733"
"2020/05/14","498741","0","0","0","498741"
"2020/05/13","232079","0","0","0","232079"
"2020/05/12","376766","0","0","0","376766"
"2020/05/11","247657","0","0","0","247657"
"2020/05/08","308090","0","0","0","308090"
"2020/05/07","204892","0","0","0","204892"
"2020/05/06","264426","0","0","0","264426"
"2020/05/04","294466","0","0","0","294466"
"2020/04/29","276752","0","0","0","276752"
"2020/04/28","256784","0","0","0","256784"
"2020/04/27","113465","0","0","0","113465"
"2020/04/24","253566","0","0","0","253566"
"2020/04/23","342474","0","0","0","342474"
"2020/04/22","431371","0","0","0","431371"
"2020/04/21","377405","0","0","0","377405"
"2020/04/20","398534","0","0","0","398534"
"2020/04/17","590822","0","0","0","590822"
"2020/04/16","301597","0","0","0","301597"
"2020/04/14","160911","0","0","0","160911"
"2020/04/13","538652","0","0","0","538652"
"2020/04/10","763819","0","0","0","763819"
"2020/04/09","344146","0","0","0","344146"
"2020/04/08","269065","0","0","0","269065"
"2020/04/07","207264","0","0","0","207264"
"2020/04/06","181498","0","0","0","181498"
"2020/04/03","309222","0","0","0","309222"
"2020/04/02","296578","0","0","0","296578"
"2020/04/01","336112","0","0","0","336112"
"2020/03/31","386219","0","0","0","386219"
"2020/03/30","202700","0","0","0","202700"
"2020/03/27","318141","0","0","0","318141"
"2020/03/26","471734","0","0","0","471734"
"2020/03/25","372872","0","0","0","372872"
"2020/03/24","352195","0","0","0","352195"
"2020/03/23","530803","0","0","0","530803"
"2020/03/20","588218","0","0","0","588218"
"2020/03/19","251202","0","0","0","251202"
"2020/03/18","619950","0","0","0","619950"
"2020/03/17","1019331","0","0","0","1019331"
"2020/03/16","11322744","0","0","0","11322744"
"2020/03/13","12675179","327716","28783065","0","41785960"
"2020/03/12","8192082","230502","22587782","0","31010366"
"2020/03/11","10584817","289175","18107612","0","28981604"
"2020/03/10","5312778","298320","17657593","0","23268691"
"2020/03/09","12118890","226373","23221601","0","35566864"
"2020/03/06","11023866","283244","15215319","0","26522429"
"2020/03/05","10583892","452370","13451469","0","24487731"
"2020/03/04","6791207","681464","13471648","0","20944319"
"2020/03/03","8589302","529317","13154385","0","22273004"
"2020/03/02","5204610","306016","17245307","0","22755933"
"2020/02/28","6937942","604235","18664279","0","26206456"
"2020/02/27","7915972","345531","13130816","2000","21394319"
"2020/02/26","7226367","261362","12182230","0","19669959"
"2020/02/25","8279046","300899","15677992","0","24257937"
"2020/02/24","6889815","426183","18025426","2000","25343424"
"2020/02/21","7134296","389612","14544907","0","22068815"
"2020/02/20","6974387","447842","11717820","0","19140049"
"2020/02/19","4211230","403936","10069479","0","14684645"
"2020/02/18","5323728","278925","8825358","0","14428011"
"2020/02/17","5431604","228385","8495884","0","14155873"
"2020/02/14","5220129","289154","10547138","0","16056421"
"2020/02/13","4270212","280953","12888698","0","17439863"
"2020/02/12","4726650","562072","12264649","0","17553371"
"2020/02/11","3711592","174060","8185132","0","12070784"
"2020/02/10","5069495","441491","7754763","0","13265749"
"2020/02/07","6736174","445273","8580496","0","15761943"
"2020/02/06","5579864","277740","9640786","0","15498390"
"2020/02/05","10880307","312321","11025205","0","22217833"
"2020/02/04","9618494","484421","11093166","0","21196081"
"2020/02/03","5036569","526201","15228249","0","20791019"
"2020/01/31","6075633","507380","14165813","0","20748826"
"2020/01/30","6596555","276803","10836565","0","17709923"
"2020/01/29","6090364","294405","10916213","0","17300982"
"2020/01/28","6567707","390594","15643345","0","22601646"
"2020/01/23","6017045","398493","7474771","0","13890309"
"2020/01/22","3899427","339650","8568510","0","12807587"
"2020/01/21","4078551","336397","9965564","0","14380512"
"2020/01/20","5361412","189173","7181095","0","12731680"
"2020/01/17","5022689","106839","7760181","0","12889709"
"2020/01/16","6243857","280116","8917929","0","15441902"
"2020/01/15","4627303","383362","9004927","0","14015592"
"2020/01/14","5554198","231425","9097729","0","14883352"
"2020/01/13","5807448","139112","7848418","0","13794978"
"2020/01/10","5129724","141885","7849543","0","13121152"
"2020/01/09","5265706","271622","11138406","0","16675734"
"2020/01/08","5161993","284087","13164830","0","18610910"
"2020/01/07","3627906","270121","7112215","0","11010242"
"2020/01/06","3783324","215700","9213745","0","13212769"
"2020/01/03","4130722","255150","7602272","0","11988144"
"2020/01/02","3003599","93083","7643520","0","10740202"