일자,기관,개인,외국인,기타,전체
"2022/07/08","1048745","132119","2389841","0","3570705"
"2022/07/07","569005","54597","2095836","0","2719438"
"2022/07/06","1563102","107450","2491073","0","4161625"
"2022/07/05","1061071","133583","2770513","0","3965167"
"2022/07/04","1602393","117213","2675027","0","4394633"
"2022/07/01","1238822","112726","2870039","71","4221658"
"2022/06/30","1185891","79374","2411177","0","3676442"
"2022/06/29","1617067","93982","2105129","0","3816178"
"2022/06/28","1058158","110176","2358702","0","3527036"
"2022/06/27","1661821","105916","2348879","0","4116616"
"2022/06/24","886760","175230","2528884","0","3590874"
"2022/06/23","1399172","99601","2973898","0","4472671"
"2022/06/22","1183595","100629","3150965","0","4435189"
"2022/06/21","990268","65614","2876782","0","3932664"
"2022/06/20","1025352","80983","2972106","0","4078441"
"2022/06/17","1014385","63476","2774942","0","3852803"
"2022/06/16","464981","61121","2127165","0","2653267"
"2022/06/15","915133","102953","3823456","0","4841542"
"2022/06/14","1194719","88370","3231547","0","4514636"
"2022/06/13","1709556","56369","3074641","0","4840566"
"2022/06/10","3688799","56772","3273152","0","7018723"
"2022/06/09","1106444","89850","3598472","0","4794766"
"2022/06/08","670428","57484","2578184","0","3306096"
"2022/06/07","666711","38582","2166159","5","2871457"
"2022/06/03","373488","57048","2552824","0","2983360"
"2022/06/02","968662","34796","2202690","0","3206148"
"2022/05/31","547172","117029","2450455","0","3114656"
"2022/05/30","321957","42037","1984234","0","2348228"
"2022/05/27","672943","58179","2205866","0","2936988"
"2022/05/26","1225921","67151","2337604","0","3630676"
"2022/05/25","1066701","110706","2576345","0","3753752"
"2022/05/24","2345721","78388","2316452","0","4740561"
"2022/05/23","1666907","105305","2280383","0","4052595"
"2022/05/20","597250","56869","1927297","0","2581416"
"2022/05/19","2532020","106511","2123783","0","4762314"
"2022/05/18","2123389","73367","1752181","0","3948937"
"2022/05/17","497223","119626","3145253","0","3762102"
"2022/05/16","1227332","77530","2394145","0","3699007"
"2022/05/13","623861","143408","2650687","45","3418001"
"2022/05/12","3062320","85875","3757343","85","6905623"
"2022/05/11","1453301","120172","3131062","1","4704536"
"2022/05/10","1543817","83057","3031232","82","4658188"
"2022/05/09","928823","50413","2291046","48","3270330"
"2022/05/06","1946727","56511","2423112","0","4426350"
"2022/05/04","803434","73314","2106818","0","2983566"
"2022/05/03","478905","75941","2433507","0","2988353"
"2022/05/02","1337837","58700","1787151","0","3183688"
"2022/04/29","516352","77010","1826125","0","2419487"
"2022/04/28","514592","77474","3075128","0","3667194"
"2022/04/27","1224579","99875","2041045","0","3365499"
"2022/04/26","775662","83785","2239912","0","3099359"
"2022/04/25","1561809","82135","2672558","0","4316502"
"2022/04/22","1896849","67098","2009026","0","3972973"
"2022/04/21","572153","71903","2139611","0","2783667"
"2022/04/20","831389","104643","2512562","0","3448594"
"2022/04/19","397331","97330","2061870","0","2556531"
"2022/04/18","695854","54480","2279000","43","3029377"
"2022/04/15","1457934","66709","1793256","0","3317899"
"2022/04/14","1232752","77357","1656864","0","2966973"
"2022/04/13","715231","98994","2344276","0","3158501"
"2022/04/12","1620769","123075","2273067","0","4016911"
"2022/04/11","2239636","84228","2109624","0","4433488"
"2022/04/08","749251","79022","2225983","0","3054256"
"2022/04/07","1206621","116655","2824780","0","4148056"
"2022/04/06","3052003","60315","2221470","0","5333788"
"2022/04/05","1040059","102601","2203989","0","3346649"
"2022/04/04","709225","124007","3524687","0","4357919"
"2022/04/01","1286818","82569","2321853","0","3691240"
"2022/03/31","632740","89901","2032456","0","2755097"
"2022/03/30","663491","103189","2207004","0","2973684"
"2022/03/29","683251","114674","2507528","68","3305521"
"2022/03/28","2392472","82324","2134924","70","4609790"
"2022/03/25","1721679","126554","2384127","270","4232630"
"2022/03/24","1096001","64204","2792698","127","3953030"
"2022/03/23","1147594","50316","1831407","0","3029317"
"2022/03/22","936991","43760","1805608","0","2786359"
"2022/03/21","1015770","82801","1836523","43","2935137"
"2022/03/18","966999","64861","2120224","0","3152084"
"2022/03/17","538313","86430","1971702","0","2596445"
"2022/03/16","750730","204504","2695231","317","3650782"
"2022/03/15","1025813","162851","2173711","0","3362375"
"2022/03/14","1279863","84277","2573223","0","3937363"
"2022/03/11","865837","98564","2293102","0","3257503"
"2022/03/10","1267547","123666","3103489","0","4494702"
"2022/03/08","1153233","68760","2911472","0","4133465"
"2022/03/07","2199241","65578","2504935","0","4769754"
"2022/03/04","2298649","69512","2494544","288","4862993"
"2022/03/03","1563315","114600","2313248","0","3991163"
"2022/03/02","745918","103189","2394404","0","3243511"
"2022/02/28","1783496","58655","1955576","0","3797727"
"2022/02/25","983931","118067","2915660","0","4017658"
"2022/02/24","2055257","66823","3207611","60","5329751"
"2022/02/23","1625554","55142","2191729","0","3872425"
"2022/02/22","2175929","83542","2243295","0","4502766"
"2022/02/21","1327605","67046","1413096","0","2807747"
"2022/02/18","1662604","80122","2077244","0","3819970"
"2022/02/17","2057858","170788","2759932","3000","4991578"
"2022/02/16","1876728","131879","3632884","500","5641991"
"2022/02/15","711390","91932","2495160","533","3299015"
"2022/02/14","921758","95631","2073992","0","3091381"
"2022/02/11","1978047","156079","2485506","24","4619656"
"2022/02/10","2158421","82191","3940800","17","6181429"
"2022/02/09","834302","135969","2194947","331","3165549"
"2022/02/08","1142883","158538","4040726","211","5342358"
"2022/02/07","1590692","99209","3422842","0","5112743"
"2022/02/04","1376146","153744","2301917","0","3831807"
"2022/02/03","1033250","147825","2524880","38","3705993"
"2022/01/28","1705488","131939","2988956","0","4826383"
"2022/01/27","1319744","157078","3920081","0","5396903"
"2022/01/26","960696","133131","2965960","0","4059787"
"2022/01/25","1174506","94635","2857674","0","4126815"
"2022/01/24","621942","98788","2952202","0","3672932"
"2022/01/21","1343475","76719","2527195","0","3947389"
"2022/01/20","794532","82786","2152664","0","3029982"
"2022/01/19","1274444","81818","2439368","0","3795630"
"2022/01/18","846282","71027","2503555","0","3420864"
"2022/01/17","425049","74441","3013382","0","3512872"
"2022/01/14","1256048","70491","2885074","0","4211613"
"2022/01/13","1399161","84765","4049761","0","5533687"
"2022/01/12","775405","64264","2994986","135","3834790"
"2022/01/11","952193","78616","3584331","234","4615374"
"2022/01/10","1350046","49673","2332621","81","3732421"
"2022/01/07","1256175","112065","2419942","60","3788242"
"2022/01/06","1159228","78748","2792921","73","4030970"
"2022/01/05","799460","67994","2896709","153","3764316"
"2022/01/04","642203","98756","2599701","3","3340663"
"2022/01/03","690033","78157","1923052","0","2691242"
"2021/12/30","1966469","63916","1972176","0","4002561"
"2021/12/29","2446471","142276","2919397","0","5508144"
"2021/12/28","527733","129215","2611629","0","3268577"
"2021/12/27","128507","55787","1341960","0","1526254"
"2021/12/24","249337","76803","1386363","0","1712503"
"2021/12/23","351832","129708","2974915","0","3456455"
"2021/12/22","683398","89301","2393197","0","3165896"
"2021/12/21","587719","135789","2489034","0","3212542"
"2021/12/20","598568","96851","2351302","0","3046721"
"2021/12/17","1261913","60580","2231379","0","3553872"
"2021/12/16","351960","89409","1844920","0","2286289"
"2021/12/15","578610","108793","2359720","0","3047123"
"2021/12/14","561166","60409","2168398","0","2789973"
"2021/12/13","844256","74724","2286172","0","3205152"
"2021/12/10","3685612","71341","2789785","0","6546738"
"2021/12/09","1217522","76938","2880065","0","4174525"
"2021/12/08","625270","87367","2584855","91","3297583"
"2021/12/07","623448","70381","2733668","99","3427596"
"2021/12/06","1683859","87606","3018519","100","4790084"
"2021/12/03","753433","93128","2718419","0","3564980"
"2021/12/02","690002","106727","3486201","115","4283045"
"2021/12/01","777090","103643","2894761","0","3775494"
"2021/11/30","1009863","84743","5081330","0","6175936"
"2021/11/29","1257994","66357","2541686","0","3866037"
"2021/11/26","2096005","104695","2945654","0","5146354"
"2021/11/25","1208385","64620","2589976","0","3862981"
"2021/11/24","986027","103786","3321834","0","4411647"
"2021/11/23","1162936","64396","2455025","1","3682358"
"2021/11/22","779607","92992","3497713","0","4370312"
"2021/11/19","783916","47729","2739727","0","3571372"
"2021/11/18","565423","63746","3439776","0","4068945"
"2021/11/17","858561","72199","4510908","0","5441668"
"2021/11/16","1655209","94236","3323575","0","5073020"
"2021/11/15","1319514","80554","3962055","0","5362123"
"2021/11/12","1749408","105705","3383208","0","5238321"
"2021/11/11","1772599","90549","2637208","0","4500356"
"2021/11/10","2120797","57186","2876986","0","5054969"
"2021/11/09","1355650","91734","2863862","0","4311246"
"2021/11/08","1499923","82464","2740916","0","4323303"
"2021/11/05","993682","81381","2613993","0","3689056"
"2021/11/04","599312","76462","2626027","0","3301801"
"2021/11/03","1484148","91137","2489668","0","4064953"
"2021/11/02","821940","115097","2715417","0","3652454"
"2021/11/01","717164","88430","2402744","0","3208338"
"2021/10/29","2063795","80877","4361431","0","6506103"
"2021/10/28","1163172","104191","2397474","0","3664837"
"2021/10/27","1128611","65556","1721157","0","2915324"
"2021/10/26","389434","52447","2441997","0","2883878"
"2021/10/25","372501","38456","2167260","0","2578217"
"2021/10/22","1666034","78359","2137244","0","3881637"
"2021/10/21","1098536","92683","2852405","0","4043624"
"2021/10/20","665867","76443","3029532","0","3771842"
"2021/10/19","1042299","38138","2820689","0","3901126"
"2021/10/18","1625872","102320","3246509","17","4974718"
"2021/10/15","1146657","101454","3144590","0","4392701"
"2021/10/14","900993","46981","3071676","0","4019650"
"2021/10/13","639163","89711","2845613","0","3574487"
"2021/10/12","765979","106069","3312938","0","4184986"
"2021/10/08","2890949","65162","3519894","11","6476016"
"2021/10/07","830165","92940","3798923","66","4722094"
"2021/10/06","884486","82351","4611429","18","5578284"
"2021/10/05","751568","81922","3850614","0","4684104"
"2021/10/01","1391522","58042","3781150","0","5230714"
"2021/09/30","1073694","75638","6232638","0","7381970"
"2021/09/29","1149841","63573","2788666","0","4002080"
"2021/09/28","1521795","75578","3226610","0","4823983"
"2021/09/27","1126048","95573","2728540","0","3950161"
"2021/09/24","1467952","265776","4728973","0","6462701"
"2021/09/23","436421","35191","1998218","0","2469830"
"2021/09/17","2173360","59580","2808554","0","5041494"
"2021/09/16","1780262","49793","2751680","0","4581735"
"2021/09/15","1199419","116618","2809195","1000","4126232"
"2021/09/14","1378341","59711","2467616","52","3905720"
"2021/09/13","1664251","41318","2824285","0","4529854"
"2021/09/10","1302569","90329","2669536","19","4062453"
"2021/09/09","1745403","53727","3101456","0","4900586"
"2021/09/08","1540851","72642","3135656","0","4749149"
"2021/09/07","1078223","56889","2755495","0","3890607"
"2021/09/06","439216","65749","2134078","83","2639126"
"2021/09/03","456073","71639","2589932","0","3117644"
"2021/09/02","1337500","87968","2995284","0","4420752"
"2021/09/01","1394186","56085","3399749","944","4850964"
"2021/08/31","868069","74793","3449415","0","4392277"
"2021/08/30","1088885","79440","2760781","0","3929106"
"2021/08/27","337245","52241","5560388","3001","5952875"
"2021/08/26","1343969","78237","3050804","1000","4474010"
"2021/08/25","2376688","96441","3209381","2020","5684530"
"2021/08/24","1364360","121692","3205804","56","4691912"
"2021/08/23","1180163","129905","3748094","0","5058162"
"2021/08/20","1113061","61619","4036021","0","5210701"
"2021/08/19","1776601","102030","4391406","0","6270037"
"2021/08/18","834928","110592","4055889","0","5001409"
"2021/08/17","1304194","79828","3538094","0","4922116"
"2021/08/13","1167810","91771","3666880","0","4926461"
"2021/08/12","1143633","92451","4394111","0","5630195"
"2021/08/11","2181298","122253","2969428","0","5272979"
"2021/08/10","944842","153105","3769040","0","4866987"
"2021/08/09","3531692","165263","2701973","19","6398947"
"2021/08/06","1314712","91231","2295641","0","3701584"
"2021/08/05","845875","49799","1877490","0","2773164"
"2021/08/04","1192711","98454","2043305","0","3334470"
"2021/08/03","1358342","83713","2513035","10","3955100"
"2021/08/02","486037","100104","1920855","0","2506996"
"2021/07/30","1803005","91833","2098162","0","3993000"
"2021/07/29","545048","97406","2024517","0","2666971"
"2021/07/28","1624109","108949","2876221","0","4609279"
"2021/07/27","1140395","134224","2895093","0","4169712"
"2021/07/26","1347181","73669","3101338","0","4522188"
"2021/07/23","781571","59887","2432637","0","3274095"
"2021/07/22","792260","82387","3111871","303","3986821"
"2021/07/21","778717","59317","3210042","0","4048076"
"2021/07/20","1007917","102057","2790433","0","3900407"
"2021/07/19","780631","109912","2717254","0","3607797"
"2021/07/16","915799","56168","2321527","0","3293494"
"2021/07/15","1511354","129753","3641686","119","5282912"
"2021/07/14","1191383","71406","2063949","678","3327416"
"2021/07/13","840055","79328","2442645","177","3362205"
"2021/07/12","566647","60299","2027259","84","2654289"
"2021/07/09","892851","83421","3187952","0","4164224"
"2021/07/08","1000873","64689","3406700","0","4472262"
"2021/07/07","983704","70800","2305433","0","3359937"
"2021/07/06","1077264","44808","2757076","0","3879148"
"2021/07/05","398416","82252","2070237","1500","2552405"
"2021/07/02","1018326","110553","2815990","0","3944869"
"2021/07/01","779263","63172","2531470","0","3373905"
"2021/06/30","709067","70429","2159692","0","2939188"
"2021/06/29","1668499","55909","2626502","0","4350910"
"2021/06/28","423525","55850","2206350","0","2685725"
"2021/06/25","544995","42140","2295448","0","2882583"
"2021/06/24","797823","57993","3888796","174","4744786"
"2021/06/23","744957","53466","3575887","516","4374826"
"2021/06/22","500118","59774","3945857","0","4505749"
"2021/06/21","813796","71327","3403026","100","4288249"
"2021/06/18","757394","50903","3302538","500","4111335"
"2021/06/17","1078945","41280","3371364","93","4491682"
"2021/06/16","507100","29997","2767194","0","3304291"
"2021/06/15","909313","52085","3632527","0","4593925"
"2021/06/14","200428","71416","3115787","606","3388237"
"2021/06/11","1604877","73024","4245612","600","5924113"
"2021/06/10","443352","109346","3335218","152","3888068"
"2021/06/09","214392","100667","3547089","179","3862327"
"2021/06/08","90473","68759","2346207","312","2505751"
"2021/06/07","93733","56729","2474200","0","2624662"
"2021/06/04","478809","47705","2799644","0","3326158"
"2021/06/03","224956","44783","2853395","0","3123134"
"2021/06/02","174416","47328","3179644","0","3401388"
"2021/06/01","262460","32904","2615639","340","2911343"
"2021/05/31","514433","73111","3144748","104","3732396"
"2021/05/28","350215","29549","3183380","0","3563144"
"2021/05/27","460042","48707","3454809","0","3963558"
"2021/05/26","392153","55314","1909394","0","2356861"
"2021/05/25","453535","62216","2240956","0","2756707"
"2021/05/24","517539","46145","2596953","0","3160637"
"2021/05/21","254325","64289","3969048","130","4287792"
"2021/05/20","442582","110623","2751718","0","3304923"
"2021/05/18","372436","89252","3406256","1377","3869321"
"2021/05/17","578422","80727","3511630","0","4170779"
"2021/05/14","215794","109427","2712422","0","3037643"
"2021/05/13","217783","83357","3198661","0","3499801"
"2021/05/12","1067827","162128","4341829","0","5571784"
"2021/05/11","519433","135325","5011618","4874","5671250"
"2021/05/10","385447","84362","3523933","0","3993742"
"2021/05/07","163629","103148","4449324","0","4716101"
"2021/05/06","577289","110665","5303852","0","5991806"
"2021/05/04","665271","162120","5501534","0","6328925"
"2021/05/03","1596920","181306","7918292","0","9696518"
"2021/04/30","45440","0","0","0","45440"
"2021/04/29","70564","0","0","0","70564"
"2021/04/28","71038","0","0","0","71038"
"2021/04/27","91042","0","0","0","91042"
"2021/04/26","57346","0","0","0","57346"
"2021/04/23","40147","0","0","0","40147"
"2021/04/22","41107","0","0","0","41107"
"2021/04/21","90183","0","0","0","90183"
"2021/04/20","39108","0","0","0","39108"
"2021/04/19","90943","0","0","0","90943"
"2021/04/16","47611","0","0","0","47611"
"2021/04/15","41180","0","0","0","41180"
"2021/04/14","99122","0","0","0","99122"
"2021/04/13","95067","0","0","0","95067"
"2021/04/12","97708","0","0","0","97708"
"2021/04/09","54299","0","0","0","54299"
"2021/04/08","99726","0","0","0","99726"
"2021/04/07","92657","0","0","0","92657"
"2021/04/06","33825","0","0","0","33825"
"2021/04/05","66588","0","0","0","66588"
"2021/04/02","108667","0","0","0","108667"
"2021/04/01","75784","0","0","0","75784"
"2021/03/31","50304","0","0","0","50304"
"2021/03/30","59579","0","0","0","59579"
"2021/03/29","38894","0","0","0","38894"
"2021/03/26","28348","0","0","0","28348"
"2021/03/25","47517","0","0","0","47517"
"2021/03/24","120000","0","0","0","120000"
"2021/03/23","45565","0","0","0","45565"
"2021/03/22","63330","0","0","0","63330"
"2021/03/19","145858","0","0","0","145858"
"2021/03/18","52987","0","0","0","52987"
"2021/03/17","74084","0","0","0","74084"
"2021/03/16","67653","0","0","0","67653"
"2021/03/15","50047","0","0","0","50047"
"2021/03/12","41123","0","0","0","41123"
"2021/03/11","41803","0","0","0","41803"
"2021/03/10","45409","0","0","0","45409"
"2021/03/09","125339","0","0","0","125339"
"2021/03/08","13747","0","0","0","13747"
"2021/03/05","309843","0","0","0","309843"
"2021/03/04","499170","0","0","0","499170"
"2021/03/03","96417","0","0","0","96417"
"2021/03/02","50983","0","0","0","50983"
"2021/02/26","51838","0","0","0","51838"
"2021/02/25","108939","0","0","0","108939"
"2021/02/24","66623","0","0","0","66623"
"2021/02/23","15947","0","0","0","15947"
"2021/02/22","166685","0","0","0","166685"
"2021/02/19","51275","0","0","0","51275"
"2021/02/18","59836","0","0","0","59836"
"2021/02/17","57928","0","0","0","57928"
"2021/02/16","28141","0","0","0","28141"
"2021/02/15","123513","0","0","0","123513"
"2021/02/10","17868","0","0","0","17868"
"2021/02/09","19394","0","0","0","19394"
"2021/02/08","92878","0","0","0","92878"
"2021/02/05","25413","0","0","0","25413"
"2021/02/04","52409","0","0","0","52409"
"2021/02/03","59999","0","0","0","59999"
"2021/02/02","59773","0","0","0","59773"
"2021/02/01","49297","0","0","0","49297"
"2021/01/29","53377","0","0","0","53377"
"2021/01/28","33186","0","0","0","33186"
"2021/01/27","59305","0","0","0","59305"
"2021/01/26","40472","0","0","0","40472"
"2021/01/25","21896","0","0","0","21896"
"2021/01/22","102725","0","0","0","102725"
"2021/01/21","49861","0","0","0","49861"
"2021/01/20","120306","0","0","0","120306"
"2021/01/19","82106","0","0","0","82106"
"2021/01/18","55648","0","0","0","55648"
"2021/01/15","102981","0","0","0","102981"
"2021/01/14","126999","0","0","0","126999"
"2021/01/13","114652","0","0","0","114652"
"2021/01/12","78320","0","0","0","78320"
"2021/01/11","131510","0","0","0","131510"
"2021/01/08","138031","0","0","0","138031"
"2021/01/07","71128","0","0","0","71128"
"2021/01/06","46612","0","0","0","46612"
"2021/01/05","105768","0","0","0","105768"
"2021/01/04","262582","0","0","0","262582"
"2020/12/30","191193","0","0","0","191193"
"2020/12/29","67621","0","0","0","67621"
"2020/12/28","110078","0","0","0","110078"
"2020/12/24","102137","0","0","0","102137"
"2020/12/23","53936","0","0","0","53936"
"2020/12/22","54787","0","0","0","54787"
"2020/12/21","79593","0","0","0","79593"
"2020/12/18","62871","0","0","0","62871"
"2020/12/17","82377","0","0","0","82377"
"2020/12/16","206897","0","0","0","206897"
"2020/12/15","111681","0","0","0","111681"
"2020/12/14","161823","0","0","0","161823"
"2020/12/11","266037","0","0","0","266037"
"2020/12/10","1023547","0","0","0","1023547"
"2020/12/09","110843","0","0","0","110843"
"2020/12/08","72051","0","0","0","72051"
"2020/12/07","137608","0","0","0","137608"
"2020/12/04","81112","0","0","0","81112"
"2020/12/03","120251","0","0","0","120251"
"2020/12/02","83422","0","0","0","83422"
"2020/12/01","31300","0","0","0","31300"
"2020/11/30","118653","0","0","0","118653"
"2020/11/27","93212","0","0","0","93212"
"2020/11/26","118774","0","0","0","118774"
"2020/11/25","89233","0","0","0","89233"
"2020/11/24","106437","0","0","0","106437"
"2020/11/23","60195","0","0","0","60195"
"2020/11/20","61336","0","0","0","61336"
"2020/11/19","47882","0","0","0","47882"
"2020/11/18","60760","0","0","0","60760"
"2020/11/17","69752","0","0","0","69752"
"2020/11/16","48953","0","0","0","48953"
"2020/11/13","36534","0","0","0","36534"
"2020/11/12","67157","0","0","0","67157"
"2020/11/11","37477","0","0","0","37477"
"2020/11/10","30836","0","0","0","30836"
"2020/11/09","50705","0","0","0","50705"
"2020/11/06","47544","0","0","0","47544"
"2020/11/05","46827","0","0","0","46827"
"2020/11/04","61621","0","0","0","61621"
"2020/11/03","56420","0","0","0","56420"
"2020/11/02","22302","0","0","0","22302"
"2020/10/30","41996","0","0","0","41996"
"2020/10/29","35887","0","0","0","35887"
"2020/10/28","59384","0","0","0","59384"
"2020/10/27","65925","0","0","0","65925"
"2020/10/26","46774","0","0","0","46774"
"2020/10/23","72253","0","0","0","72253"
"2020/10/22","28511","0","0","0","28511"
"2020/10/21","43727","0","0","0","43727"
"2020/10/20","83955","0","0","0","83955"
"2020/10/19","47316","0","0","0","47316"
"2020/10/16","68648","0","0","0","68648"
"2020/10/15","106368","0","0","0","106368"
"2020/10/14","86408","0","0","0","86408"
"2020/10/13","61731","0","0","0","61731"
"2020/10/12","197193","0","0","0","197193"
"2020/10/08","108109","0","0","0","108109"
"2020/10/07","75187","0","0","0","75187"
"2020/10/06","54757","0","0","0","54757"
"2020/10/05","46394","0","0","0","46394"
"2020/09/29","72895","0","0","0","72895"
"2020/09/28","80150","0","0","0","80150"
"2020/09/25","43810","0","0","0","43810"
"2020/09/24","71352","0","0","0","71352"
"2020/09/23","76753","0","0","0","76753"
"2020/09/22","69978","0","0","0","69978"
"2020/09/21","110688","0","0","0","110688"
"2020/09/18","436746","0","0","0","436746"
"2020/09/17","64264","0","0","0","64264"
"2020/09/16","558648","0","0","0","558648"
"2020/09/15","121104","0","0","0","121104"
"2020/09/14","111447","0","0","0","111447"
"2020/09/11","344744","0","0","0","344744"
"2020/09/10","351996","0","0","0","351996"
"2020/09/09","597064","0","0","0","597064"
"2020/09/08","192039","0","0","0","192039"
"2020/09/07","73800","0","0","0","73800"
"2020/09/04","74041","0","0","0","74041"
"2020/09/03","90994","0","0","0","90994"
"2020/09/02","58832","0","0","0","58832"
"2020/09/01","67137","0","0","0","67137"
"2020/08/31","120112","0","0","0","120112"
"2020/08/28","53700","0","0","0","53700"
"2020/08/27","79798","0","0","0","79798"
"2020/08/26","74827","0","0","0","74827"
"2020/08/25","67449","0","0","0","67449"
"2020/08/24","88305","0","0","0","88305"
"2020/08/21","99102","0","0","0","99102"
"2020/08/20","85348","0","0","0","85348"
"2020/08/19","95705","0","0","0","95705"
"2020/08/18","105225","0","0","0","105225"
"2020/08/14","74575","0","0","0","74575"
"2020/08/13","96420","0","0","0","96420"
"2020/08/12","66938","0","0","0","66938"
"2020/08/11","105975","0","0","0","105975"
"2020/08/10","77556","0","0","0","77556"
"2020/08/07","53622","0","0","0","53622"
"2020/08/06","53879","0","0","0","53879"
"2020/08/05","46148","0","0","0","46148"
"2020/08/04","85101","0","0","0","85101"
"2020/08/03","133874","0","0","0","133874"
"2020/07/31","88361","0","0","0","88361"
"2020/07/30","98273","0","0","0","98273"
"2020/07/29","53949","0","0","0","53949"
"2020/07/28","61013","0","0","0","61013"
"2020/07/27","96647","0","0","0","96647"
"2020/07/24","64620","0","0","0","64620"
"2020/07/23","124800","0","0","0","124800"
"2020/07/22","111239","0","0","0","111239"
"2020/07/21","99192","0","0","0","99192"
"2020/07/20","84351","0","0","0","84351"
"2020/07/17","79098","0","0","0","79098"
"2020/07/16","104859","0","0","0","104859"
"2020/07/15","85571","0","0","0","85571"
"2020/07/14","67421","0","0","0","67421"
"2020/07/13","95949","0","0","0","95949"
"2020/07/10","174242","0","0","0","174242"
"2020/07/09","163495","0","0","0","163495"
"2020/07/08","153536","0","0","0","153536"
"2020/07/07","112269","0","0","0","112269"
"2020/07/06","103800","0","0","0","103800"
"2020/07/03","106654","0","0","0","106654"
"2020/07/02","170649","0","0","0","170649"
"2020/07/01","56513","0","0","0","56513"
"2020/06/30","211238","0","0","0","211238"
"2020/06/29","137825","0","0","0","137825"
"2020/06/26","72861","0","0","0","72861"
"2020/06/25","145307","0","0","0","145307"
"2020/06/24","81994","0","0","0","81994"
"2020/06/23","296270","0","0","0","296270"
"2020/06/22","73841","0","0","0","73841"
"2020/06/19","75228","0","0","0","75228"
"2020/06/18","100493","0","0","0","100493"
"2020/06/17","117547","0","0","0","117547"
"2020/06/16","100011","0","0","0","100011"
"2020/06/15","50785","0","0","0","50785"
"2020/06/12","222234","0","0","0","222234"
"2020/06/11","348509","0","0","0","348509"
"2020/06/10","38369","0","0","0","38369"
"2020/06/09","48047","0","0","0","48047"
"2020/06/08","57748","0","0","0","57748"
"2020/06/05","31026","0","0","0","31026"
"2020/06/04","33189","0","0","0","33189"
"2020/06/03","65855","0","0","0","65855"
"2020/06/02","47941","0","0","0","47941"
"2020/06/01","124741","0","0","0","124741"
"2020/05/29","546814","0","0","0","546814"
"2020/05/28","75010","0","0","0","75010"
"2020/05/27","73038","0","0","0","73038"
"2020/05/26","108430","0","0","0","108430"
"2020/05/25","77010","0","0","0","77010"
"2020/05/22","56783","0","0","0","56783"
"2020/05/21","56601","0","0","0","56601"
"2020/05/20","77145","0","0","0","77145"
"2020/05/19","86320","0","0","0","86320"
"2020/05/18","73385","0","0","0","73385"
"2020/05/15","59099","0","0","0","59099"
"2020/05/14","74226","0","0","0","74226"
"2020/05/13","89786","0","0","0","89786"
"2020/05/12","79938","0","0","0","79938"
"2020/05/11","53148","0","0","0","53148"
"2020/05/08","56455","0","0","0","56455"
"2020/05/07","20105","0","0","0","20105"
"2020/05/06","48197","0","0","0","48197"
"2020/05/04","33082","0","0","0","33082"
"2020/04/29","130730","0","0","0","130730"
"2020/04/28","52076","0","0","0","52076"
"2020/04/27","17822","0","0","0","17822"
"2020/04/24","41447","0","0","0","41447"
"2020/04/23","52109","0","0","0","52109"
"2020/04/22","82526","0","0","0","82526"
"2020/04/21","46870","0","0","0","46870"
"2020/04/20","87403","0","0","0","87403"
"2020/04/17","26700","0","0","0","26700"
"2020/04/16","76754","0","0","0","76754"
"2020/04/14","45170","0","0","0","45170"
"2020/04/13","73564","0","0","0","73564"
"2020/04/10","71901","0","0","0","71901"
"2020/04/09","137628","0","0","0","137628"
"2020/04/08","64452","0","0","0","64452"
"2020/04/07","68611","0","0","0","68611"
"2020/04/06","48205","0","0","0","48205"
"2020/04/03","170121","0","0","0","170121"
"2020/04/02","127231","0","0","0","127231"
"2020/04/01","147444","0","0","0","147444"
"2020/03/31","236323","0","0","0","236323"
"2020/03/30","93982","0","0","0","93982"
"2020/03/27","172151","0","0","0","172151"
"2020/03/26","95495","0","0","0","95495"
"2020/03/25","164130","0","0","0","164130"
"2020/03/24","190515","0","0","0","190515"
"2020/03/23","125156","0","0","0","125156"
"2020/03/20","93120","0","0","0","93120"
"2020/03/19","87012","0","0","0","87012"
"2020/03/18","59958","0","0","0","59958"
"2020/03/17","224932","0","0","0","224932"
"2020/03/16","1202853","0","0","0","1202853"
"2020/03/13","2020261","423567","19275634","28000","21747462"
"2020/03/12","1955322","412635","18215426","0","20583383"
"2020/03/11","1087366","390640","19021199","32000","20531205"
"2020/03/10","1308872","672755","14805860","0","16787487"
"2020/03/09","1645919","477155","18518164","0","20641238"
"2020/03/06","1719457","473063","14387071","0","16579591"
"2020/03/05","1497431","439052","12292204","0","14228687"
"2020/03/04","936031","449217","12011726","0","13396974"
"2020/03/03","1639312","355737","16488756","20000","18503805"
"2020/03/02","1462306","325211","14484400","0","16271917"
"2020/02/28","1774519","489931","20411811","0","22676261"
"2020/02/27","1966269","431775","17608949","5000","20011993"
"2020/02/26","1417909","432170","15064068","0","16914147"
"2020/02/25","1024810","327968","14906851","0","16259629"
"2020/02/24","1569537","501892","19264312","0","21335741"
"2020/02/21","1195375","242142","14136810","0","15574327"
"2020/02/20","1676034","429804","13186952","0","15292790"
"2020/02/19","1811318","666100","13069291","0","15546709"
"2020/02/18","2688607","481408","17127151","0","20297166"
"2020/02/17","1179960","440056","14951531","0","16571547"
"2020/02/14","1540383","471886","14250756","0","16263025"
"2020/02/13","2011492","456849","15034345","0","17502686"
"2020/02/12","1171900","360727","16067224","0","17599851"
"2020/02/11","1075710","323618","10552741","4000","11956069"
"2020/02/10","1127769","444002","8392997","0","9964768"
"2020/02/07","1477584","339065","9831264","10000","11657913"
"2020/02/06","1387221","338086","10797812","0","12523119"
"2020/02/05","1748440","664892","9261021","0","11674353"
"2020/02/04","1980810","416326","12520167","0","14917303"
"2020/02/03","1718168","649752","13643166","0","16011086"
"2020/01/31","1494894","432698","13894851","0","15822443"
"2020/01/30","2376552","492485","15642006","0","18511043"
"2020/01/29","1108483","515963","13292306","0","14916752"
"2020/01/28","2691153","430117","14314360","0","17435630"
"2020/01/23","1331920","208829","9567210","0","11107959"
"2020/01/22","1520862","401322","10072184","0","11994368"
"2020/01/21","1777305","350294","10915896","0","13043495"
"2020/01/20","2106320","228950","12040128","0","14375398"
"2020/01/17","1361106","261099","8947104","0","10569309"
"2020/01/16","2619095","388896","10686005","10000","13703996"
"2020/01/15","1476102","418582","10416742","0","12311426"
"2020/01/14","1533817","461796","10979226","0","12974839"
"2020/01/13","2069673","508477","10787925","0","13366075"
"2020/01/10","1611565","723150","10531893","0","12866608"
"2020/01/09","1776340","325995","8842149","0","10944484"
"2020/01/08","1669330","498257","15709920","0","17877507"
"2020/01/07","1584978","372098","10808689","0","12765765"
"2020/01/06","2139181","406918","11616872","0","14162971"
"2020/01/03","2457478","335579","10330737","0","13123794"
"2020/01/02","1343010","279727","7648309","0","9271046"