일자,기관,개인,외국인,기타,전체
"2022/07/08","78221857117","10536015955","260159633965","0","348917507037"
"2022/07/07","63642526013","15888774200","290974425130","0","370505725343"
"2022/07/06","103409047751","15718598950","327912180300","0","447039827001"
"2022/07/05","55942059634","15982184580","292249149905","23025600","364196419719"
"2022/07/04","95533492240","11556552790","287555988165","0","394646033195"
"2022/07/01","120777251249","15193093770","350470685440","8789400","486449819859"
"2022/06/30","155660885187","12966793895","292800299520","0","461427978602"
"2022/06/29","136410463056","12859311415","305639228000","0","454909002471"
"2022/06/28","75149315358","12939339595","223451675115","0","311540330068"
"2022/06/27","61945648899","9390173645","209149155530","0","280484978074"
"2022/06/24","44604259483","13807189085","321822388640","0","380233837208"
"2022/06/23","109908774722","14972603405","461810740005","0","586692118132"
"2022/06/22","83944281148","9234906980","410501253380","0","503680441508"
"2022/06/21","71265973415","12647719225","270180912695","0","354094605335"
"2022/06/20","104115207395","7643017785","357299023410","0","469057248590"
"2022/06/17","154210436157","12164485515","605950140075","0","772325061747"
"2022/06/16","93487785953","13086010050","284013778155","0","390587574158"
"2022/06/15","95170521079","13978129540","401654330270","184736600","510987717489"
"2022/06/14","104180057502","14066444095","453035882940","0","571282384537"
"2022/06/13","155350763597","7642040420","425042517615","0","588035321632"
"2022/06/10","195969324528","10018836915","366820676420","0","572808837863"
"2022/06/09","192040009113","9057495090","573535268575","0","774632772778"
"2022/06/08","111609579372","8521486610","301077356325","0","421208422307"
"2022/06/07","98707809005","9443025405","240617369865","0","348768204275"
"2022/06/03","48919498627","7245944145","219484988625","0","275650431397"
"2022/06/02","73614978163","4942392670","410600915295","0","489158286128"
"2022/05/31","83442528479","12297300890","521632775510","0","617372604879"
"2022/05/30","60244076083","8620290610","310183625570","0","379047992263"
"2022/05/27","57025488852","6465926385","260964316065","0","324455731302"
"2022/05/26","80837381861","8293236540","326666641760","0","415797260161"
"2022/05/25","105394152752","6915832915","386307578350","0","498617564017"
"2022/05/24","93552284047","4646704550","309246947725","0","407445936322"
"2022/05/23","72015201962","5778540880","273357473500","0","351151216342"
"2022/05/20","80795535649","8225124590","320550818585","0","409571478824"
"2022/05/19","149059122639","6624781785","356932753965","0","512616658389"
"2022/05/18","114575517635","5032480320","351488760495","0","471096758450"
"2022/05/17","97858479211","6878688100","398308209560","0","503045376871"
"2022/05/16","81659978340","6258616030","366671214585","0","454589808955"
"2022/05/13","117458474109","13335316760","476191222955","0","606985013824"
"2022/05/12","278656726369","11734161320","466955056455","0","757345944144"
"2022/05/11","166881584861","8051971045","338318857470","0","513252413376"
"2022/05/10","138056462017","8276825440","458432425020","0","604765712477"
"2022/05/09","157359129302","5926850895","315346475690","0","478632455887"
"2022/05/06","192958393242","8877848550","386084226530","0","587920468322"
"2022/05/04","98670391944","8013358200","274400408750","0","381084158894"
"2022/05/03","95518336492","5333808760","257232693565","0","358084838817"
"2022/05/02","117591397111","7486043870","277134988725","0","402212429706"
"2022/04/29","112513256164","8771835540","330609336630","0","451894428334"
"2022/04/28","138011334102","10292700020","460314951850","0","608618985972"
"2022/04/27","120274160858","10831553550","371929903205","0","503035617613"
"2022/04/26","104914067670","7274201725","372776692420","0","484964961815"
"2022/04/25","189820582382","8665348460","355156275115","0","553642205957"
"2022/04/22","169185002177","6780124290","353155423175","0","529120549642"
"2022/04/21","87245000099","4434989130","270248692780","0","361928682009"
"2022/04/20","116754646627","5498368550","260565698455","0","382818713632"
"2022/04/19","76256545270","5267664645","200555770340","0","282079980255"
"2022/04/18","122208921903","4541439890","199357557595","0","326107919388"
"2022/04/15","171636923345","7293580170","228367635265","0","407298138780"
"2022/04/14","186227134540","8509986790","304666873095","0","499403994425"
"2022/04/13","76132431110","7516889790","236716796575","0","320366117475"
"2022/04/12","97142534282","4895817015","305613568960","0","407651920257"
"2022/04/11","106175696130","4819309805","306818617300","0","417813623235"
"2022/04/08","121880998260","7330716975","302168186990","0","431379902225"
"2022/04/07","190022663104","6499952580","370417205805","0","566939821489"
"2022/04/06","145395769637","5564678335","314304594865","0","465265042837"
"2022/04/05","81952744593","5752177490","221863635595","0","309568557678"
"2022/04/04","68832358351","5596705180","189874315575","0","264303379106"
"2022/04/01","91898772049","7685801725","282391308100","0","381975881874"
"2022/03/31","91556340143","8280385420","249439612785","0","349276338348"
"2022/03/30","105231000763","5601915650","261307758290","0","372140674703"
"2022/03/29","93030158494","5648314865","247668024310","0","346346497669"
"2022/03/28","130763137648","6761099640","246393086195","0","383917323483"
"2022/03/25","100240062595","5920730135","210327116630","0","316487909360"
"2022/03/24","102175836756","10383255970","248560896340","0","361119989066"
"2022/03/23","97895834912","8345874605","293120661435","6089150","399368460102"
"2022/03/22","111296663460","8652247010","273607988895","0","393556899365"
"2022/03/21","120063018690","9704778960","249425732065","5684000","379199213715"
"2022/03/18","86538725182","10731391745","394168320165","0","491438437092"
"2022/03/17","116107554251","10101465415","325595452710","219689960","452024162336"
"2022/03/16","85421271082","10387642945","381732382840","0","477541296867"
"2022/03/15","120129138839","8868184675","447941542410","0","576938865924"
"2022/03/14","150154335381","12472509125","628081966935","0","790708811441"
"2022/03/11","183067345369","14248788920","548052176684","0","745368310973"
"2022/03/10","158024601140","18793743445","615450300333","0","792268644918"
"2022/03/08","196077741970","14352636375","380092644080","0","590523022425"
"2022/03/07","437669885437","12706237770","373642617494","0","824018740701"
"2022/03/04","159682892380","18838212290","279078197475","0","457599302145"
"2022/03/03","77874807797","11493098940","243201122945","0","332569029682"
"2022/03/02","70243491874","9355236490","341449708480","0","421048436844"
"2022/02/28","129761658587","10830160010","339168259550","11930800","479772008947"
"2022/02/25","68431788873","14224952185","320808862105","6457600","403472060763"
"2022/02/24","131161506482","11009081295","352155833095","0","494326420872"
"2022/02/23","65514536251","11440891510","301341647400","5941350","378303016511"
"2022/02/22","93819943245","9728902360","306965544975","0","410514390580"
"2022/02/21","63146884189","8261811755","209287720435","21860300","280718276679"
"2022/02/18","100609946585","12752213705","259462135335","16750","372824312375"
"2022/02/17","119235314132","12144484885","262335385190","4671500","393719855707"
"2022/02/16","95579683091","13003050105","295318952870","0","403901686066"
"2022/02/15","134476169345","14580196220","273390751760","0","422447117325"
"2022/02/14","157546710237","9694341865","284199864050","0","451440916152"
"2022/02/11","204546095038","11383107760","463690720860","0","679619923658"
"2022/02/10","200665285367","16407627405","458089876770","0","675162789542"
"2022/02/09","90240643307","9714483180","349177424675","0","449132551162"
"2022/02/08","143892598464","10827339275","384158594249","12216400","538890748388"
"2022/02/07","117463624210","7328791480","348676031335","5945000","473474392025"
"2022/02/04","83844453396","11331386665","279981256850","0","375157096911"
"2022/02/03","108136316946","10651382355","396515102850","0","515302802151"
"2022/01/28","97019507470","15496267200","544749736915","0","657265511585"
"2022/01/27","133768648293","14145771655","558055606995","0","705970026943"
"2022/01/26","84570697180","12076012660","368964265170","369000","465611344010"
"2022/01/25","129464189982","7566001595","432236612475","0","569266804052"
"2022/01/24","87031689265","6799273350","350942174035","0","444773136650"
"2022/01/21","137713694655","10411738955","355586165935","0","503711599545"
"2022/01/20","77716379932","10134719585","352997063020","0","440848162537"
"2022/01/19","135544604564","12987963925","447244568530","0","595777137019"
"2022/01/18","141687133008","10466701935","406606856430","0","558760691373"
"2022/01/17","152789008602","10856485360","445713821899","0","609359315861"
"2022/01/14","184435859430","15450009910","458355815048","0","658241684388"
"2022/01/13","281867407861","9654840730","328975409125","0","620497657716"
"2022/01/12","156739400914","19840547580","386235871135","0","562815819629"
"2022/01/11","153607079376","10780184840","351668640995","0","516055905211"
"2022/01/10","214700651101","12128828095","465023584935","0","691853064131"
"2022/01/07","148113425559","8240621320","526335124750","0","682689171629"
"2022/01/06","171415478397","11707247180","498875275935","15620000","682013621512"
"2022/01/05","323499018115","8124837170","436351597695","0","767975452980"
"2022/01/04","146751888260","9585892310","290174386995","0","446512167565"
"2022/01/03","102152338200","5657554960","215489146140","0","323299039300"
"2021/12/30","82227648879","4927778535","213398561285","0","300553988699"
"2021/12/29","141889565491","8792726180","246913491260","9475000","397605257931"
"2021/12/28","64341546923","7916177530","222511169850","0","294768894303"
"2021/12/27","51588202328","3202273800","138905930715","0","193696406843"
"2021/12/24","43285148499","3817210540","180283884230","0","227386243269"
"2021/12/23","52448835270","7783697155","237262394841","0","297494927266"
"2021/12/22","50518704306","5545057520","225805682845","0","281869444671"
"2021/12/21","65559980141","8148114480","259737116080","0","333445210701"
"2021/12/20","86208822096","6038688935","236484462630","0","328731973661"
"2021/12/17","81145486325","7543799265","476605993200","0","565295278790"
"2021/12/16","90334846007","6181784690","210086163665","0","306602794362"
"2021/12/15","77171681874","7106688435","231928199215","0","316206569524"
"2021/12/14","110085388008","6153278340","268694303110","16750000","384949719458"
"2021/12/13","78335627048","5075318700","238658354385","0","322069300133"
"2021/12/10","116540793091","4223134450","218096881170","57046570","338917855281"
"2021/12/09","177890372292","7392978420","504230919505","0","689514270217"
"2021/12/08","69399058937","5718299660","276033632910","104785160","351255776667"
"2021/12/07","110379422681","6501569925","267153292340","38030400","384072315346"
"2021/12/06","72527238032","4374699930","269661653615","144800000","346708391577"
"2021/12/03","97362905478","6438094010","280517989770","0","384318989258"
"2021/12/02","87655040497","8880121380","404878589115","0","501413750992"
"2021/12/01","73438058231","12483217900","291185059405","0","377106335536"
"2021/11/30","116015052514","14911195805","687571458790","0","818497707109"
"2021/11/29","109155095162","9549183055","412278781320","0","530983059537"
"2021/11/26","98822594683","6535382330","336047514120","0","441405491133"
"2021/11/25","45389671734","5487907220","260019174965","0","310896753919"
"2021/11/24","50315039022","5527171000","310083489405","0","365925699427"
"2021/11/23","58523822139","6590930250","343845302050","0","408960054439"
"2021/11/22","80433581207","6553111040","403568285860","0","490554978107"
"2021/11/19","47177474747","6120218900","351321821925","0","404619515572"
"2021/11/18","62796442440","9405575490","296972615337","0","369174633267"
"2021/11/17","94925841590","5682371600","334929401400","0","435537614590"
"2021/11/16","71335897305","5921746370","316065376722","0","393323020397"
"2021/11/15","128507447556","10011638250","329415778310","0","467934864116"
"2021/11/12","131828531569","8530355870","343658727955","0","484017615394"
"2021/11/11","131000518708","17499237725","380058972650","0","528558729083"
"2021/11/10","67495308192","7773210490","311036345825","0","386304864507"
"2021/11/09","71833196760","5665399825","282086962370","0","359585558955"
"2021/11/08","110950948877","7723116495","324782401165","0","443456466537"
"2021/11/05","81856529077","10093592900","345141820860","0","437091942837"
"2021/11/04","70570039306","9826934170","336443228660","0","416840202136"
"2021/11/03","43403854657","8845410885","379180527295","0","431429792837"
"2021/11/02","54909238078","8382785450","237501286220","0","300793309748"
"2021/11/01","60856615575","8407490350","278522460730","9592680","347796159335"
"2021/10/29","88471244242","5861956885","350117243140","0","444450444267"
"2021/10/28","86064021916","7987450320","313564590530","0","407616062766"
"2021/10/27","105475252497","8469651310","342205990780","87220000","456238114587"
"2021/10/26","79116208987","6409419690","330606398540","0","416132027217"
"2021/10/25","83739570486","8835698655","243547857975","0","336123127116"
"2021/10/22","51688337953","7590608650","244054755620","0","303333702223"
"2021/10/21","51664830146","8731878360","294783409625","0","355180118131"
"2021/10/20","73190372705","6873149990","358671673860","0","438735196555"
"2021/10/19","61360125845","6342806665","252882973720","0","320585906230"
"2021/10/18","86815021070","4818984485","261647889365","0","353281894920"
"2021/10/15","110535979176","7508118870","297537364515","0","415581462561"
"2021/10/14","139687574173","9760757660","385807197365","0","535255529198"
"2021/10/13","117145526297","7728184400","352457756140","0","477331466837"
"2021/10/12","126155681494","9128722870","427475618555","0","562760022919"
"2021/10/08","116850521914","13928573525","416066082930","0","546845178369"
"2021/10/07","77110738334","11894714450","312162121100","0","401167573884"
"2021/10/06","118538990168","9052999810","392229620290","24148000","519845758268"
"2021/10/05","158904644317","11196406565","526863718755","0","696964769637"
"2021/10/01","189912212915","9552981120","341638973005","0","541104167040"
"2021/09/30","187654485984","9632648695","355924513430","0","553211648109"
"2021/09/29","173895742941","10700540340","340434645185","0","525030928466"
"2021/09/28","124965569356","9192945490","271352785835","95710000","405607010681"
"2021/09/27","73927501984","7857705085","245073072580","0","326858279649"
"2021/09/24","82045903903","6847866380","357279790015","0","446173560298"
"2021/09/23","68337069149","7411696985","335281197004","529000","411030492138"
"2021/09/17","109708746211","8249813550","472142757785","551000","590101868546"
"2021/09/16","62476113511","6830243635","386344033458","192000","455650582604"
"2021/09/15","105275090162","6836286850","338039886910","191000","450151454922"
"2021/09/14","74274329112","6405695645","355746296535","385500","436426706792"
"2021/09/13","116382152398","8609371540","285514661545","0","410506185483"
"2021/09/10","166281114398","9597521930","497715363775","1208000","673595208103"
"2021/09/09","175721734908","7015860970","347406874910","0","530144470788"
"2021/09/08","136537028443","10194639755","450075581622","1108000","596808357820"
"2021/09/07","68668263649","5393404085","271177287615","0","345238955349"
"2021/09/06","38457239826","4651955180","252100622310","0","295209817316"
"2021/09/03","62940570079","6611604045","372981365405","599500","442534139029"
"2021/09/02","72790148458","6880282150","315415343605","0","395085774213"
"2021/09/01","79514452955","6271953690","285350154450","0","371136561095"
"2021/08/31","80656368912","8713315600","349089768125","0","438459452637"
"2021/08/30","61471405591","8116898315","300578020590","615000","370166939496"
"2021/08/27","53618829088","7697714505","235315664970","0","296632208563"
"2021/08/26","85402766437","8765837165","393132906805","0","487301510407"
"2021/08/25","70255811932","10092911055","347678607725","0","428027330712"
"2021/08/24","82769422244","7291491935","435881401415","5880000","525948195594"
"2021/08/23","82756487001","11049349060","427330775745","0","521136611806"
"2021/08/20","82838755339","10130572125","394350626620","6480000","487326434084"
"2021/08/19","90702989777","8378747590","313331998750","0","412413736117"
"2021/08/18","54113945801","9005510290","248468388249","0","311587844340"
"2021/08/17","89750894662","13163423650","369820334455","2910000","472737562767"
"2021/08/13","118357981390","8003131300","432134015275","0","558495127965"
"2021/08/12","121260052427","10159298440","357808361505","0","489227712372"
"2021/08/11","82531488525","8516335080","378020687755","0","469068511360"
"2021/08/10","90106736370","19111886625","285919471390","0","395138094385"
"2021/08/09","117338378052","5142701470","247432107295","0","369913186817"
"2021/08/06","62799726928","6283954690","267923487040","0","337007168658"
"2021/08/05","58600076479","8859401210","241592973135","0","309052450824"
"2021/08/04","49452088141","8618845710","261796778835","0","319867712686"
"2021/08/03","51939233401","7463306655","294655052885","2880000","354060472941"
"2021/08/02","53151392699","5776884615","285641436915","0","344569714229"
"2021/07/30","69255993816","7551313725","288619266715","0","365426574256"
"2021/07/29","40199751573","5835212975","247893290650","0","293928255198"
"2021/07/28","55633732321","6241027285","310943857815","0","372818617421"
"2021/07/27","60356986218","5566891085","260588104525","0","326511981828"
"2021/07/26","81203241545","5927642815","259091634500","0","346222518860"
"2021/07/23","76203413134","7901158910","267756589965","0","351861162009"
"2021/07/22","92201436227","7995837970","265339435970","0","365536710167"
"2021/07/21","125685302435","7267344445","245178343290","0","378130990170"
"2021/07/20","96350990932","7838060775","297797038570","0","401986090277"
"2021/07/19","98259074939","4885508870","210444640000","0","313589223809"
"2021/07/16","125150386528","5803576340","277146302125","15750000","408116014993"
"2021/07/15","110604889863","6785742770","280567942550","0","397958575183"
"2021/07/14","78070673417","6772553835","294243973995","0","379087201247"
"2021/07/13","97352417401","7426678290","257831097685","0","362610193376"
"2021/07/12","71464866769","5675253940","217251553515","0","294391674224"
"2021/07/09","180892720002","7659951990","348372768930","0","536925440922"
"2021/07/08","90406639077","6444266265","332586142385","0","429437047727"
"2021/07/07","110080729915","6342537390","244213831460","0","360637098765"
"2021/07/06","72779150527","5931730420","187657737475","0","266368618422"
"2021/07/05","66914665916","6924251995","199188446105","0","273027364016"
"2021/07/02","64129718322","5336870840","211080297310","0","280546886472"
"2021/07/01","111412797988","9618423540","317790282680","0","438821504208"
"2021/06/30","73197127905","7998832135","228833972965","0","310029933005"
"2021/06/29","82123591299","6610141970","205843886040","0","294577619309"
"2021/06/28","91486482740","8716763155","256057217960","0","356260463855"
"2021/06/25","101991111007","9682281080","224340476605","0","336013868692"
"2021/06/24","183822212146","12420609845","329382437920","0","525625259911"
"2021/06/23","122260422021","9843024005","291174980010","20690500","423299116536"
"2021/06/22","80414741666","8298727780","259469023060","0","348182492506"
"2021/06/21","131888071839","4810964890","358669075175","0","495368111904"
"2021/06/18","89817298941","4953150355","281344664525","0","376115113821"
"2021/06/17","155294292998","5168735100","304168855035","0","464631883133"
"2021/06/16","66496218906","4698153860","224726235408","0","295920608174"
"2021/06/15","43987681285","5122778340","343466974150","0","392577433775"
"2021/06/14","49580171764","5655393550","206067356710","4248000","261307170024"
"2021/06/11","117808378792","7901998400","341373412255","26673700","467110463147"
"2021/06/10","126053718815","8851189800","391357003160","0","526261911775"
"2021/06/09","121240111078","7655691360","246489683415","19617800","375405103653"
"2021/06/08","85126018458","10071972395","276212667895","0","371410658748"
"2021/06/07","114936755114","8219028580","288030963060","22447340","411209194094"
"2021/06/04","125541397752","8800228545","311682560655","0","446024186952"
"2021/06/03","67715540372","5459317835","298605895830","0","371780754037"
"2021/06/02","125236706302","9790434870","333088526305","0","468115667477"
"2021/06/01","62989821206","7701336935","318132694470","12012150","388835864761"
"2021/05/31","91105610708","4517767470","365716020400","92106620","461431505198"
"2021/05/28","82678333332","5075559270","356732631540","15927000","444502451142"
"2021/05/27","81884757657","6902109360","652451282580","0","741238149597"
"2021/05/26","69173893064","5967856965","494266004580","0","569407754609"
"2021/05/25","44049622442","7612681120","377760705755","16060800","429439070117"
"2021/05/24","71370228139","7909683085","436917623520","16141000","516213675744"
"2021/05/21","87497777278","10261780055","469398047355","30217200","567187821888"
"2021/05/20","78400630999","7828683140","531892967585","0","618122281724"
"2021/05/18","53355789549","8844208000","411273246605","0","473473244154"
"2021/05/17","94386603042","6741361095","346759934611","0","447887898748"
"2021/05/14","64715276016","9705101055","350244321460","16110000","424680808531"
"2021/05/13","120012033270","10600329460","601031429840","43641860","731687434430"
"2021/05/12","99777664828","9932382355","706546924855","29702000","816286674038"
"2021/05/11","93853147765","9009004070","586421465435","2675200","689286292470"
"2021/05/10","49791789074","9290849645","395289166735","1373500","454373178954"
"2021/05/07","38123351874","8344111390","351364119420","382500","397831965184"
"2021/05/06","52333737964","11538926975","598143939195","0","662016604134"
"2021/05/04","85016825643","10990763195","619900976110","0","715908564948"
"2021/05/03","62573024203","13412146460","753931912570","0","829917083233"
"2021/04/30","15250052698","0","0","0","15250052698"
"2021/04/29","10793647915","0","0","0","10793647915"
"2021/04/28","19667328271","0","0","0","19667328271"
"2021/04/27","18461928427","0","0","0","18461928427"
"2021/04/26","17555294324","0","0","0","17555294324"
"2021/04/23","10650618984","0","0","0","10650618984"
"2021/04/22","8997394555","0","0","0","8997394555"
"2021/04/21","21635607673","0","0","0","21635607673"
"2021/04/20","8699459546","0","0","0","8699459546"
"2021/04/19","8240573447","0","0","0","8240573447"
"2021/04/16","6075557308","0","0","0","6075557308"
"2021/04/15","17864340702","0","0","0","17864340702"
"2021/04/14","6382153779","0","0","0","6382153779"
"2021/04/13","9215464255","0","0","0","9215464255"
"2021/04/12","8227100333","0","0","0","8227100333"
"2021/04/09","14074227928","0","0","0","14074227928"
"2021/04/08","17826298227","0","0","0","17826298227"
"2021/04/07","16321052200","0","0","0","16321052200"
"2021/04/06","13519131735","0","0","0","13519131735"
"2021/04/05","5426766419","0","0","0","5426766419"
"2021/04/02","11738165198","0","0","0","11738165198"
"2021/04/01","14187337909","0","0","0","14187337909"
"2021/03/31","15276554947","0","0","0","15276554947"
"2021/03/30","10222600824","0","0","0","10222600824"
"2021/03/29","19104642874","0","0","0","19104642874"
"2021/03/26","11414310942","0","0","0","11414310942"
"2021/03/25","9586407533","0","0","0","9586407533"
"2021/03/24","8493085903","0","0","0","8493085903"
"2021/03/23","10327614156","0","0","0","10327614156"
"2021/03/22","13691374709","0","0","0","13691374709"
"2021/03/19","28415819902","0","0","0","28415819902"
"2021/03/18","12175657735","0","0","0","12175657735"
"2021/03/17","21800868291","0","0","0","21800868291"
"2021/03/16","9041451447","0","0","0","9041451447"
"2021/03/15","21733770815","0","0","0","21733770815"
"2021/03/12","11943697855","0","0","0","11943697855"
"2021/03/11","15303070355","0","0","0","15303070355"
"2021/03/10","5072474612","0","0","0","5072474612"
"2021/03/09","10132396450","0","0","0","10132396450"
"2021/03/08","6237610855","0","0","0","6237610855"
"2021/03/05","17616098543","0","0","0","17616098543"
"2021/03/04","16650826693","0","0","0","16650826693"
"2021/03/03","3839507182","0","0","0","3839507182"
"2021/03/02","11036249531","0","0","0","11036249531"
"2021/02/26","19905180071","0","0","0","19905180071"
"2021/02/25","7665261156","0","0","0","7665261156"
"2021/02/24","8474311674","0","0","0","8474311674"
"2021/02/23","7181947334","0","0","0","7181947334"
"2021/02/22","8957520357","0","0","0","8957520357"
"2021/02/19","10045251027","0","0","0","10045251027"
"2021/02/18","8718677782","0","0","0","8718677782"
"2021/02/17","10451529588","0","0","0","10451529588"
"2021/02/16","5709673794","0","0","0","5709673794"
"2021/02/15","4621947118","0","0","0","4621947118"
"2021/02/10","5191771938","0","0","0","5191771938"
"2021/02/09","7857011397","0","0","0","7857011397"
"2021/02/08","11445022999","0","0","0","11445022999"
"2021/02/05","8914438284","0","0","0","8914438284"
"2021/02/04","11901597490","0","0","0","11901597490"
"2021/02/03","5333766488","0","0","0","5333766488"
"2021/02/02","10534111977","0","0","0","10534111977"
"2021/02/01","11528837744","0","0","0","11528837744"
"2021/01/29","12117028467","0","0","0","12117028467"
"2021/01/28","9396231438","0","0","0","9396231438"
"2021/01/27","11463273599","0","0","0","11463273599"
"2021/01/26","13770392399","0","0","0","13770392399"
"2021/01/25","12165731063","0","0","0","12165731063"
"2021/01/22","13621266642","0","0","0","13621266642"
"2021/01/21","13072231798","0","0","0","13072231798"
"2021/01/20","7703123621","0","0","0","7703123621"
"2021/01/19","13204142167","0","0","0","13204142167"
"2021/01/18","12034930566","0","0","0","12034930566"
"2021/01/15","10377046950","0","0","0","10377046950"
"2021/01/14","11063934652","0","0","0","11063934652"
"2021/01/13","9441229082","0","0","0","9441229082"
"2021/01/12","11918772069","0","0","0","11918772069"
"2021/01/11","8369405213","0","0","0","8369405213"
"2021/01/08","15758050170","0","0","0","15758050170"
"2021/01/07","8899480971","0","0","0","8899480971"
"2021/01/06","12510404426","0","0","0","12510404426"
"2021/01/05","13862504742","0","0","0","13862504742"
"2021/01/04","31128651988","0","0","0","31128651988"
"2020/12/30","13211520756","0","0","0","13211520756"
"2020/12/29","9784974721","0","0","0","9784974721"
"2020/12/28","7989972776","0","0","0","7989972776"
"2020/12/24","7898001076","0","0","0","7898001076"
"2020/12/23","16444530427","0","0","0","16444530427"
"2020/12/22","7065805350","0","0","0","7065805350"
"2020/12/21","6207359854","0","0","0","6207359854"
"2020/12/18","7143644810","0","0","0","7143644810"
"2020/12/17","7567235287","0","0","0","7567235287"
"2020/12/16","15592773231","0","0","0","15592773231"
"2020/12/15","11454126780","0","0","0","11454126780"
"2020/12/14","14960956307","0","0","0","14960956307"
"2020/12/11","25970723422","0","0","0","25970723422"
"2020/12/10","48094668416","0","0","0","48094668416"
"2020/12/09","10198830851","0","0","0","10198830851"
"2020/12/08","7944735553","0","0","0","7944735553"
"2020/12/07","7437904671","0","0","0","7437904671"
"2020/12/04","10835122842","0","0","0","10835122842"
"2020/12/03","5857623652","0","0","0","5857623652"
"2020/12/02","6602220844","0","0","0","6602220844"
"2020/12/01","6457514819","0","0","0","6457514819"
"2020/11/30","16365914219","0","0","0","16365914219"
"2020/11/27","8756828548","0","0","0","8756828548"
"2020/11/26","9099194472","0","0","0","9099194472"
"2020/11/25","8138047378","0","0","0","8138047378"
"2020/11/24","9243721652","0","0","0","9243721652"
"2020/11/23","10019706348","0","0","0","10019706348"
"2020/11/20","7339105493","0","0","0","7339105493"
"2020/11/19","6107046601","0","0","0","6107046601"
"2020/11/18","6976747561","0","0","0","6976747561"
"2020/11/17","7748670045","0","0","0","7748670045"
"2020/11/16","11572825258","0","0","0","11572825258"
"2020/11/13","5690646558","0","0","0","5690646558"
"2020/11/12","7745347004","0","0","0","7745347004"
"2020/11/11","8724812625","0","0","0","8724812625"
"2020/11/10","7261251382","0","0","0","7261251382"
"2020/11/09","9978701289","0","0","0","9978701289"
"2020/11/06","8783700689","0","0","0","8783700689"
"2020/11/05","8968520024","0","0","0","8968520024"
"2020/11/04","10735219895","0","0","0","10735219895"
"2020/11/03","9132589530","0","0","0","9132589530"
"2020/11/02","3924095502","0","0","0","3924095502"
"2020/10/30","7762206930","0","0","0","7762206930"
"2020/10/29","4791828180","0","0","0","4791828180"
"2020/10/28","4105001061","0","0","0","4105001061"
"2020/10/27","6223063915","0","0","0","6223063915"
"2020/10/26","7473690634","0","0","0","7473690634"
"2020/10/23","5060062045","0","0","0","5060062045"
"2020/10/22","4408811641","0","0","0","4408811641"
"2020/10/21","6494408997","0","0","0","6494408997"
"2020/10/20","8608939746","0","0","0","8608939746"
"2020/10/19","7775602522","0","0","0","7775602522"
"2020/10/16","5641538043","0","0","0","5641538043"
"2020/10/15","5384382808","0","0","0","5384382808"
"2020/10/14","4223832625","0","0","0","4223832625"
"2020/10/13","4455838965","0","0","0","4455838965"
"2020/10/12","7353865843","0","0","0","7353865843"
"2020/10/08","9486286630","0","0","0","9486286630"
"2020/10/07","3110995534","0","0","0","3110995534"
"2020/10/06","3999700100","0","0","0","3999700100"
"2020/10/05","5105990394","0","0","0","5105990394"
"2020/09/29","9214238918","0","0","0","9214238918"
"2020/09/28","8809210876","0","0","0","8809210876"
"2020/09/25","6924656888","0","0","0","6924656888"
"2020/09/24","10794177701","0","0","0","10794177701"
"2020/09/23","11091270177","0","0","0","11091270177"
"2020/09/22","17437823595","0","0","0","17437823595"
"2020/09/21","10688443665","0","0","0","10688443665"
"2020/09/18","9869325622","0","0","0","9869325622"
"2020/09/17","11457659784","0","0","0","11457659784"
"2020/09/16","10030604604","0","0","0","10030604604"
"2020/09/15","10969186901","0","0","0","10969186901"
"2020/09/14","12186434011","0","0","0","12186434011"
"2020/09/11","20004074481","0","0","0","20004074481"
"2020/09/10","22949579977","0","0","0","22949579977"
"2020/09/09","8417677463","0","0","0","8417677463"
"2020/09/08","9307391759","0","0","0","9307391759"
"2020/09/07","5619326246","0","0","0","5619326246"
"2020/09/04","17215619723","0","0","0","17215619723"
"2020/09/03","14289178419","0","0","0","14289178419"
"2020/09/02","14609487049","0","0","0","14609487049"
"2020/09/01","8151709575","0","0","0","8151709575"
"2020/08/31","19981635029","0","0","0","19981635029"
"2020/08/28","12713882379","0","0","0","12713882379"
"2020/08/27","9785320335","0","0","0","9785320335"
"2020/08/26","8634253459","0","0","0","8634253459"
"2020/08/25","7537836959","0","0","0","7537836959"
"2020/08/24","7377684630","0","0","0","7377684630"
"2020/08/21","8836559420","0","0","0","8836559420"
"2020/08/20","14420791533","0","0","0","14420791533"
"2020/08/19","12782848027","0","0","0","12782848027"
"2020/08/18","13045215392","0","0","0","13045215392"
"2020/08/14","14926918466","0","0","0","14926918466"
"2020/08/13","9768725602","0","0","0","9768725602"
"2020/08/12","12447736519","0","0","0","12447736519"
"2020/08/11","12928988058","0","0","0","12928988058"
"2020/08/10","11278606764","0","0","0","11278606764"
"2020/08/07","18161606988","0","0","0","18161606988"
"2020/08/06","24351187950","0","0","0","24351187950"
"2020/08/05","13002096698","0","0","0","13002096698"
"2020/08/04","10916228803","0","0","0","10916228803"
"2020/08/03","11198202988","0","0","0","11198202988"
"2020/07/31","8044442695","0","0","0","8044442695"
"2020/07/30","8303454191","0","0","0","8303454191"
"2020/07/29","9928670233","0","0","0","9928670233"
"2020/07/28","11085356441","0","0","0","11085356441"
"2020/07/27","6514193516","0","0","0","6514193516"
"2020/07/24","10988909935","0","0","0","10988909935"
"2020/07/23","10003937535","0","0","0","10003937535"
"2020/07/22","18236387922","0","0","0","18236387922"
"2020/07/21","17102191883","0","0","0","17102191883"
"2020/07/20","7808372600","0","0","0","7808372600"
"2020/07/17","8962752246","0","0","0","8962752246"
"2020/07/16","10251366666","0","0","0","10251366666"
"2020/07/15","9842453580","0","0","0","9842453580"
"2020/07/14","9037751421","0","0","0","9037751421"
"2020/07/13","10414058082","0","0","0","10414058082"
"2020/07/10","15862523458","0","0","0","15862523458"
"2020/07/09","17278947866","0","0","0","17278947866"
"2020/07/08","6927748898","0","0","0","6927748898"
"2020/07/07","8635991991","0","0","0","8635991991"
"2020/07/06","7592011048","0","0","0","7592011048"
"2020/07/03","5754260640","0","0","0","5754260640"
"2020/07/02","12467933378","0","0","0","12467933378"
"2020/07/01","7715426960","0","0","0","7715426960"
"2020/06/30","19152369869","0","0","0","19152369869"
"2020/06/29","11057701872","0","0","0","11057701872"
"2020/06/26","8102141021","0","0","0","8102141021"
"2020/06/25","14324687048","0","0","0","14324687048"
"2020/06/24","10683274920","0","0","0","10683274920"
"2020/06/23","10383671429","0","0","0","10383671429"
"2020/06/22","7634912654","0","0","0","7634912654"
"2020/06/19","8863876330","0","0","0","8863876330"
"2020/06/18","12656124661","0","0","0","12656124661"
"2020/06/17","23281381257","0","0","0","23281381257"
"2020/06/16","21385316205","0","0","0","21385316205"
"2020/06/15","13059347589","0","0","0","13059347589"
"2020/06/12","34265437082","0","0","0","34265437082"
"2020/06/11","48734477255","0","0","0","48734477255"
"2020/06/10","6501324255","0","0","0","6501324255"
"2020/06/09","7819066151","0","0","0","7819066151"
"2020/06/08","6662567764","0","0","0","6662567764"
"2020/06/05","8093857435","0","0","0","8093857435"
"2020/06/04","12536123011","0","0","0","12536123011"
"2020/06/03","13645794263","0","0","0","13645794263"
"2020/06/02","11187404340","0","0","0","11187404340"
"2020/06/01","12268479621","0","0","0","12268479621"
"2020/05/29","18299156979","0","0","0","18299156979"
"2020/05/28","10926130045","0","0","0","10926130045"
"2020/05/27","7993255990","0","0","0","7993255990"
"2020/05/26","8692256211","0","0","0","8692256211"
"2020/05/25","12182191998","0","0","0","12182191998"
"2020/05/22","13447653757","0","0","0","13447653757"
"2020/05/21","10705309660","0","0","0","10705309660"
"2020/05/20","6737685728","0","0","0","6737685728"
"2020/05/19","9795135926","0","0","0","9795135926"
"2020/05/18","8568949545","0","0","0","8568949545"
"2020/05/15","8851532223","0","0","0","8851532223"
"2020/05/14","13830600889","0","0","0","13830600889"
"2020/05/13","7581017764","0","0","0","7581017764"
"2020/05/12","12180432684","0","0","0","12180432684"
"2020/05/11","8294386768","0","0","0","8294386768"
"2020/05/08","10205831687","0","0","0","10205831687"
"2020/05/07","7794890143","0","0","0","7794890143"
"2020/05/06","10341531389","0","0","0","10341531389"
"2020/05/04","11795415158","0","0","0","11795415158"
"2020/04/29","9963418661","0","0","0","9963418661"
"2020/04/28","8784722950","0","0","0","8784722950"
"2020/04/27","4647583941","0","0","0","4647583941"
"2020/04/24","7837726341","0","0","0","7837726341"
"2020/04/23","7865054526","0","0","0","7865054526"
"2020/04/22","8696147828","0","0","0","8696147828"
"2020/04/21","14051576458","0","0","0","14051576458"
"2020/04/20","9804711051","0","0","0","9804711051"
"2020/04/17","10805532893","0","0","0","10805532893"
"2020/04/16","9147484995","0","0","0","9147484995"
"2020/04/14","6400489395","0","0","0","6400489395"
"2020/04/13","12219830724","0","0","0","12219830724"
"2020/04/10","13066160912","0","0","0","13066160912"
"2020/04/09","13558870247","0","0","0","13558870247"
"2020/04/08","11251825925","0","0","0","11251825925"
"2020/04/07","7774346575","0","0","0","7774346575"
"2020/04/06","6806349934","0","0","0","6806349934"
"2020/04/03","13423329630","0","0","0","13423329630"
"2020/04/02","15292064938","0","0","0","15292064938"
"2020/04/01","17621857279","0","0","0","17621857279"
"2020/03/31","23599325069","0","0","0","23599325069"
"2020/03/30","8176649634","0","0","0","8176649634"
"2020/03/27","10021313548","0","0","0","10021313548"
"2020/03/26","16443745896","0","0","0","16443745896"
"2020/03/25","15085636343","0","0","0","15085636343"
"2020/03/24","12679369627","0","0","0","12679369627"
"2020/03/23","18518902537","0","0","0","18518902537"
"2020/03/20","10327757083","0","0","0","10327757083"
"2020/03/19","7809115735","0","0","0","7809115735"
"2020/03/18","27607025815","0","0","0","27607025815"
"2020/03/17","24747854214","0","0","0","24747854214"
"2020/03/16","440881627487","0","0","0","440881627487"
"2020/03/13","449849099645","7208324353","534001062538","0","991058486536"
"2020/03/12","276207856130","4219866938","591819807898","0","872247530966"
"2020/03/11","338792339069","3253670402","321269061233","0","663315070704"
"2020/03/10","168037877474","3997283563","289733672456","0","461768833493"
"2020/03/09","453164517368","2934331768","437237857537","0","893336706673"
"2020/03/06","434838155096","2003365964","214969862054","0","651811383114"
"2020/03/05","455526721650","4446520251","237371453729","0","697344695630"
"2020/03/04","281027937613","7386585360","237651159196","0","526065682169"
"2020/03/03","348658781372","5112647800","244611822143","0","598383251315"
"2020/03/02","156901930677","4754428455","328273614668","0","489929973800"
"2020/02/28","237589801696","4876755126","386271123451","0","628737680273"
"2020/02/27","337188242947","2869645190","289124648888","15290000","629197827025"
"2020/02/26","248615512949","3027146980","260413833112","0","512056493041"
"2020/02/25","258170688406","3313794158","354473498563","0","615957981127"
"2020/02/24","251146515064","3133394963","334904281106","13480000","589197671133"
"2020/02/21","273318148973","3855599103","268487973992","0","545661722068"
"2020/02/20","300346497784","3296880968","243678540191","0","547321918943"
"2020/02/19","186570468392","3368828089","195713786688","0","385653083169"
"2020/02/18","222055405636","2534973815","153722372548","0","378312751999"
"2020/02/17","166398051902","2628468975","187592456407","0","356618977284"
"2020/02/14","191892321828","3492341753","195255718572","0","390640382153"
"2020/02/13","187853895169","4077245565","278818544839","0","470749685573"
"2020/02/12","165681879075","4645266405","256908514906","0","427235660386"
"2020/02/11","156438837502","7819455785","207325649123","0","371583942410"
"2020/02/10","198055891780","3314829125","164506609443","0","365877330348"
"2020/02/07","294020766182","5452295105","186070892262","0","485543953549"
"2020/02/06","230542172967","6326008370","283189442894","0","520057624231"
"2020/02/05","502100773345","6345231350","293732046841","0","802178051536"
"2020/02/04","420158235171","7951535395","246824127053","0","674933897619"
"2020/02/03","183802039157","5092453380","295871283884","0","484765776421"
"2020/01/31","286773703809","6711525403","236600858761","0","530086087973"
"2020/01/30","296524472534","3807129342","262000171516","0","562331773392"
"2020/01/29","290764179428","3388491583","189077195421","0","483229866432"
"2020/01/28","298385881146","4737043402","258319275880","0","561442200428"
"2020/01/23","269779160127","5573255080","182307443343","0","457659858550"
"2020/01/22","144309267468","3290603710","177512111531","0","325111982709"
"2020/01/21","181872066344","3336818575","170418049577","0","355626934496"
"2020/01/20","218860386089","3541202575","157917126862","0","380318715526"
"2020/01/17","164841241927","1460486480","194043238305","0","360344966712"
"2020/01/16","264948655249","2135167075","189718333286","0","456802155610"
"2020/01/15","193802557104","2970518765","175626162676","0","372399238545"
"2020/01/14","228765972412","1832886330","193546605101","0","424145463843"
"2020/01/13","182478960229","4353501395","204790804236","0","391623265860"
"2020/01/10","185561759364","3182000295","165327866557","0","354071626216"
"2020/01/09","189541838466","3021427705","241819376326","0","434382642497"
"2020/01/08","175731372983","2579881000","266907627745","0","445218881728"
"2020/01/07","140062017520","2924582225","129899020748","0","272885620493"
"2020/01/06","135954452715","2502658310","119387130395","0","257844241420"
"2020/01/03","151261895769","2279628610","133910018112","0","287451542491"
"2020/01/02","95701958265","1656227140","118963996694","0","216322182099"