일자,기관,개인,외국인,기타,전체
"2022/07/08","31507190211","7672783870","75239743810","0","114419717891"
"2022/07/07","21411526540","2799667675","76291007695","0","100502201910"
"2022/07/06","51789919814","6121137330","91815931805","0","149726988949"
"2022/07/05","38099695392","7106994420","87002833710","0","132209523522"
"2022/07/04","56239549970","5058410355","90077951040","0","151375911365"
"2022/07/01","44750067446","4168544990","93973733910","1689800","142894036146"
"2022/06/30","41383026840","3693456700","85229618200","0","130306101740"
"2022/06/29","50943173180","2439369185","82725921235","0","136108463600"
"2022/06/28","40488850261","4052309030","83186419880","0","127727579171"
"2022/06/27","70176289613","8120033085","108346651570","0","186642974268"
"2022/06/24","42792514059","10177655615","87799392475","0","140769562149"
"2022/06/23","56351799151","5505026875","131578915315","0","193435741341"
"2022/06/22","42528617247","5295910055","89873885230","0","137698412532"
"2022/06/21","47466204088","3032157185","93534880670","0","144033241943"
"2022/06/20","41474745385","4080175775","87143959120","0","132698880280"
"2022/06/17","33524374900","3065867645","96570436135","0","133160678680"
"2022/06/16","23222320145","4296905070","62961175035","0","90480400250"
"2022/06/15","43724435038","5321068420","122796990645","0","171842494103"
"2022/06/14","47527233375","5306304865","101686877500","0","154520415740"
"2022/06/13","56429534641","3185223130","81178371340","0","140793129111"
"2022/06/10","122157907180","2540428370","90721660025","0","215419995575"
"2022/06/09","35782759673","4734610000","90217898300","0","130735267973"
"2022/06/08","33989750510","2423959600","78900971090","0","115314681200"
"2022/06/07","37614217240","1725934465","71483606225","269500","110824027430"
"2022/06/03","14541068340","2767109240","76220378375","0","93528555955"
"2022/06/02","36325661250","2230512595","70026592075","0","108582765920"
"2022/05/31","23188965057","5949595085","92329016360","0","121467576502"
"2022/05/30","19664403593","2051117315","69078013415","0","90793534323"
"2022/05/27","22292441820","3054413545","73851698960","0","99198554325"
"2022/05/26","38072309920","3146315180","76465097860","0","117683722960"
"2022/05/25","42338639581","4917762425","75970316050","0","123226718056"
"2022/05/24","74013744037","2984679765","67295382400","0","144293806202"
"2022/05/23","63989201788","5294262880","88681570935","0","157965035603"
"2022/05/20","35807368868","4065833040","65745349330","0","105618551238"
"2022/05/19","88914460924","8286955435","82632492440","0","179833908799"
"2022/05/18","68378735531","5596608695","64219296880","0","138194641106"
"2022/05/17","19683051041","6270016460","87151685220","0","113104752721"
"2022/05/16","42267106099","6136400350","68936477980","0","117339984429"
"2022/05/13","36699140999","6805144530","84084642925","10035000","127598963454"
"2022/05/12","109103294124","4137348170","125184369945","18074500","238443086739"
"2022/05/11","51872701703","6608673370","86273260790","48650","144754684513"
"2022/05/10","73476243110","4120812990","90503238535","17892400","168118187035"
"2022/05/09","40330101195","2424388795","74857848415","10550400","117622888805"
"2022/05/06","86736111431","3040822890","99723801445","0","189500735766"
"2022/05/04","35504394563","5487108000","72535296300","0","113526798863"
"2022/05/03","23911949637","4525002050","88266229420","0","116703181107"
"2022/05/02","61812812930","3222547170","79940484195","0","144975844295"
"2022/04/29","23552164325","5102084150","76145282670","0","104799531145"
"2022/04/28","25932721778","3182881025","115188766370","0","144304369173"
"2022/04/27","56781171679","4509791900","73926641710","0","135217605289"
"2022/04/26","34384120005","3986630175","126423169100","0","164793919280"
"2022/04/25","64507822310","3133729270","90944478570","0","158586030150"
"2022/04/22","70772055885","2761439740","73930137820","0","147463633445"
"2022/04/21","29547987518","4119207250","84295063325","0","117962258093"
"2022/04/20","31832273943","5445420750","95902475335","0","133180170028"
"2022/04/19","18439976140","5490616740","66051493110","0","89982085990"
"2022/04/18","27685286445","2794143240","68670062385","6967600","99156459670"
"2022/04/15","66256894579","3555276145","68246571325","0","138058742049"
"2022/04/14","59016843175","4926915350","75778518385","0","139722276910"
"2022/04/13","33597194020","4832501445","85680585495","0","124110280960"
"2022/04/12","70239486905","5276801425","100022269330","0","175538557660"
"2022/04/11","78206151585","3602939740","89329004080","0","171138095405"
"2022/04/08","44119753491","3156274230","72124286010","0","119400313731"
"2022/04/07","68450092728","5407206310","113312377515","0","187169676553"
"2022/04/06","106336273445","3654752570","83664646425","0","193655672440"
"2022/04/05","38084696204","5032111105","61917970290","0","105034777599"
"2022/04/04","24748457393","5028921960","92780889185","0","122558268538"
"2022/04/01","41235931390","3763594850","71127373135","0","116126899375"
"2022/03/31","29248947337","6074697050","61454074055","0","96777718442"
"2022/03/30","27707883494","4023908405","62093114630","0","93824906529"
"2022/03/29","28093189935","3928794000","71023694850","5508400","103051187185"
"2022/03/28","78482477256","2750290200","73109369830","5390000","154347527286"
"2022/03/25","55089713125","3221388020","77006144970","6547500","135323793615"
"2022/03/24","43692547012","3352471200","102842712545","9103000","149896833757"
"2022/03/23","42041812725","3136192740","60256812915","0","105434818380"
"2022/03/22","34938402089","2188639360","68083391405","0","105210432854"
"2022/03/21","41857445902","2257709600","65245754260","6054400","109366964162"
"2022/03/18","33479828820","2843551330","91730119475","0","128053499625"
"2022/03/17","26611572907","6101782530","89336431340","0","122049786777"
"2022/03/16","23825246945","4666601440","98055676510","4992750","126552517645"
"2022/03/15","41115045251","4193655710","95103609510","0","140412310471"
"2022/03/14","63203806845","4854392235","142978817150","0","211037016230"
"2022/03/11","49932492025","3806216360","120918090240","0","174656798625"
"2022/03/10","54059169798","5056715550","133397057835","0","192512943183"
"2022/03/08","55931365566","3080311210","132364156635","0","191375833411"
"2022/03/07","64642104568","2909384540","73908392705","0","141459881813"
"2022/03/04","78028254567","2498867620","81713339560","1419840","162241881587"
"2022/03/03","55880209191","5637128180","85079901840","0","146597239211"
"2022/03/02","25972353845","6641316275","80597356130","0","113211026250"
"2022/02/28","54046912170","3556966535","67746452120","0","125350330825"
"2022/02/25","28947774000","5325220770","83485998385","0","117758993155"
"2022/02/24","70459940795","2966441930","102673991220","2382000","176102755945"
"2022/02/23","49786945923","2224503240","75515416890","0","127526866053"
"2022/02/22","66822035966","3640987025","62553214950","0","133016237941"
"2022/02/21","45926039952","3422395990","43203814415","0","92552250357"
"2022/02/18","62169659244","3382715945","65642403465","0","131194778654"
"2022/02/17","71093802371","5025483790","97096876380","105300000","173321462541"
"2022/02/16","54493774779","5864300475","95198585040","8600000","155565260294"
"2022/02/15","33206753877","5092482760","86694659920","11097400","125004993957"
"2022/02/14","35676494305","4594061800","68966239755","0","109236795860"
"2022/02/11","72729098620","5240468405","102944831645","4296000","180918694670"
"2022/02/10","98264265176","3323234920","145709183510","3204500","247299888106"
"2022/02/09","48125505195","4480392860","82909205525","6289600","135521393180"
"2022/02/08","51468082010","5666670010","125800502250","6015300","182941269570"
"2022/02/07","74962752667","5089788425","123598724255","0","203651265347"
"2022/02/04","63724407886","5816787380","91164158950","0","160705354216"
"2022/02/03","43772376318","7491422080","117584412070","10447500","168858657968"
"2022/01/28","61715658807","6198119920","134513206120","0","202426984847"
"2022/01/27","45645207195","7970486545","173570550335","0","227186244075"
"2022/01/26","41503200312","9211497955","132448129805","0","183162828072"
"2022/01/25","51581622675","6470552290","137554518470","0","195606693435"
"2022/01/24","37035838185","6156021005","134146967365","0","177338826555"
"2022/01/21","49533152947","3862019160","115745112580","0","169140284687"
"2022/01/20","36187846445","4817512910","100056867525","0","141062226880"
"2022/01/19","57039569745","3516960340","99603237575","0","160159767660"
"2022/01/18","38650722681","3897991445","86930085555","0","129478799681"
"2022/01/17","21923724740","3822348080","93576428010","0","119322500830"
"2022/01/14","64858713475","3048922880","94659772610","0","162567408965"
"2022/01/13","77157056089","4118832760","158924594480","0","240200483329"
"2022/01/12","38606042731","3525583700","123389196440","25650000","165546472871"
"2022/01/11","63297304299","3353212660","145012207715","38254000","211700978674"
"2022/01/10","59249490417","2550116870","85067204295","15228000","146882039582"
"2022/01/07","66976590193","4576323920","110951262895","2550000","182506727008"
"2022/01/06","61190583747","4747783850","122502413940","13910750","188454692287"
"2022/01/05","50997716840","3212772160","121580864595","21587000","175812940595"
"2022/01/04","41963666532","3321485850","125137971990","316500","170423440872"
"2022/01/03","33811667401","3576379270","89395294965","0","126783341636"
"2021/12/30","84896110075","3690746925","103100421040","0","191687278040"
"2021/12/29","108316080467","4676942430","156749566160","0","269742589057"
"2021/12/28","37158678141","6032674045","122646305720","0","165837657906"
"2021/12/27","5890727602","2787755050","63837219225","0","72515701877"
"2021/12/24","14552656716","4111803640","75510167370","0","94174627726"
"2021/12/23","15340517225","6213431120","108307319670","0","129861268015"
"2021/12/22","29903410933","4277107845","80765515885","0","114946034663"
"2021/12/21","27800602494","7171053905","99441923265","0","134413579664"
"2021/12/20","27348598268","4528435635","88758038520","0","120635072423"
"2021/12/17","53621634235","2908962955","86768845300","0","143299442490"
"2021/12/16","21889761804","3545234385","83300740185","0","108735736374"
"2021/12/15","32954831359","4072543480","93971776890","0","130999151729"
"2021/12/14","23547827925","3626252550","99848369450","0","127022449925"
"2021/12/13","46402411735","4234209090","90588430850","0","141225051675"
"2021/12/10","153116435327","3709238515","120516721110","0","277342394952"
"2021/12/09","99676388095","4409721090","126691029110","0","230777138295"
"2021/12/08","33598091497","6886635750","109463188160","4540900","149952456307"
"2021/12/07","45182336141","3440439255","112201850375","4039200","160828664971"
"2021/12/06","89168176475","4978672150","124998622125","5440400","219150911150"
"2021/12/03","44956933559","5324661815","95808130320","0","146089725694"
"2021/12/02","44947587934","4770972005","124072662600","5341750","173796564289"
"2021/12/01","58227450674","5129543420","110260919595","0","173617913689"
"2021/11/30","70373647236","5829935160","200579958325","0","276783540721"
"2021/11/29","65039729723","4137041320","86356439750","0","155533210793"
"2021/11/26","88143909980","6109307350","92345452345","0","186598669675"
"2021/11/25","47556447024","4210403160","88382171680","0","140149021864"
"2021/11/24","45400947978","4883346140","99385459920","0","149669754038"
"2021/11/23","58414701055","3114918900","90009692065","234900","151539546920"
"2021/11/22","40758543388","4494760350","136833122905","0","182086426643"
"2021/11/19","46666469702","3019052720","107003613645","0","156689136067"
"2021/11/18","43934075144","5261799185","117447805090","0","166643679419"
"2021/11/17","41921548418","4405476085","142735465350","0","189062489853"
"2021/11/16","80121991350","5178768550","119913098600","0","205213858500"
"2021/11/15","85890786897","5170130075","115265735900","0","206326652872"
"2021/11/12","110357428952","5997654210","116933554075","0","233288637237"
"2021/11/11","115652000610","5623699275","93053896405","0","214329596290"
"2021/11/10","95664926486","4098324960","124292793920","0","224056045366"
"2021/11/09","65159848011","8421342070","80669627220","0","154250817301"
"2021/11/08","63294034645","5000611760","108470852460","0","176765498865"
"2021/11/05","56220731802","5857636150","92296462560","0","154374830512"
"2021/11/04","34854495078","8262766230","91084672715","0","134201934023"
"2021/11/03","65509851170","6349571010","87703852115","0","159563274295"
"2021/11/02","46492724389","5101944300","79021235400","0","130615904089"
"2021/11/01","54954677053","4510625135","93449751440","0","152915053628"
"2021/10/29","110933095990","5969964055","129132852610","0","246035912655"
"2021/10/28","56446191085","3583806850","93561358220","0","153591356155"
"2021/10/27","47391874355","4431501270","77672838640","0","129496214265"
"2021/10/26","31920578084","3609526065","124179656185","0","159709760334"
"2021/10/25","23432002475","2759499480","66750723255","0","92942225210"
"2021/10/22","66820867962","4428706910","79440858390","0","150690433262"
"2021/10/21","65347175928","5959099375","126524450550","0","197830725853"
"2021/10/20","38920824897","4093351410","109733968600","0","152748144907"
"2021/10/19","50590059377","2323929790","89954446055","0","142868435222"
"2021/10/18","64531242498","5087035830","87919388965","1232500","157538899793"
"2021/10/15","49521809200","4664493330","107632467670","0","161818770200"
"2021/10/14","48121706792","3126087505","98259077350","0","149506871647"
"2021/10/13","42459964240","4908297805","96455632790","0","143823894835"
"2021/10/12","32859123231","3352241030","103931718070","0","140143082331"
"2021/10/08","123638517009","4652870580","104388401985","1939300","232681728874"
"2021/10/07","36020372186","6079937950","134503919350","11338800","176615568286"
"2021/10/06","42178319149","4487942275","140530554720","1396800","187198212944"
"2021/10/05","38082998661","4097824035","120945979420","0","163126802116"
"2021/10/01","61745459986","3274532330","105795080150","0","170815072466"
"2021/09/30","36907033750","4056472085","151382531360","0","192346037195"
"2021/09/29","42689315225","2307891005","101166832680","0","146164038910"
"2021/09/28","57833686260","2857723890","110871678510","0","171563088660"
"2021/09/27","43670225065","2051457050","91337547840","0","137059229955"
"2021/09/24","70577092244","5267663330","142072151430","0","217916907004"
"2021/09/23","18728107085","2524527840","83213535975","0","104466170900"
"2021/09/17","80044801099","3278878345","106557769115","0","189881448559"
"2021/09/16","74092589815","2564546540","95054234830","0","171711371185"
"2021/09/15","45064002996","4170887220","83768289785","22800000","133025980001"
"2021/09/14","58170625599","3094854520","102997250925","4071600","164266802644"
"2021/09/13","93434148206","1699890780","80924696745","0","176058735731"
"2021/09/10","60097248970","4433555240","84106884270","1786500","148639474980"
"2021/09/09","91574766333","3149284265","110993661085","0","205717711683"
"2021/09/08","65046080830","2778950880","104508811655","0","172333843365"
"2021/09/07","40868289794","3530230910","82598463940","0","126996984644"
"2021/09/06","19190447704","2218973400","74152742280","6266500","95568429884"
"2021/09/03","20481946880","3052067240","97190486365","0","120724500485"
"2021/09/02","50881818830","2774366060","117632793720","0","171288978610"
"2021/09/01","50349499477","2525430730","149859722840","64192000","202798845047"
"2021/08/31","37789708963","3311663230","120512412455","0","161613784648"
"2021/08/30","43381521385","3721196000","109009544245","0","156112261630"
"2021/08/27","16573999461","2142001620","168939305935","204995200","187860302216"
"2021/08/26","51881050302","3892129140","115223590985","72000000","171068770427"
"2021/08/25","83212918784","4167320880","113110054085","142277000","200632570749"
"2021/08/24","54838933910","4801099060","116782453335","3515000","176426001305"
"2021/08/23","42704167923","5099560470","107007740865","0","154811469258"
"2021/08/20","46444612350","2373805435","115424207815","0","164242625600"
"2021/08/19","75022548961","4431620190","111616004985","0","191070174136"
"2021/08/18","41202915626","4749381030","116067873085","0","162020169741"
"2021/08/17","61589475279","3751014915","106957559620","0","172298049814"
"2021/08/13","59263269645","3816447075","96004333100","0","159084049820"
"2021/08/12","61956727013","4615819850","151392089225","0","217964636088"
"2021/08/11","80353144088","5739241120","101374985875","0","187467371083"
"2021/08/10","45669604067","3789126120","102576530715","0","152035260902"
"2021/08/09","132377130250","5620572640","85221521470","1797400","223221021760"
"2021/08/06","48023846877","2999109640","64711096230","0","115734052747"
"2021/08/05","33724891460","2138878145","67786241365","0","103650010970"
"2021/08/04","45077708039","3798037530","73535441765","0","122411187334"
"2021/08/03","60094934686","3567283250","86211157330","784000","149874159266"
"2021/08/02","21536184326","3245127815","51727897795","0","76509209936"
"2021/07/30","79452871182","2651228910","69542560380","0","151646660472"
"2021/07/29","23589863453","4508284885","72628428835","0","100726577173"
"2021/07/28","63560875093","2298847770","77004540050","0","142864262913"
"2021/07/27","38234886913","3077964920","75608845615","0","116921697448"
"2021/07/26","55902409277","4299955140","78925912975","0","139128277392"
"2021/07/23","35889721989","1881766560","80319428030","0","118090916579"
"2021/07/22","49902323780","3568194830","91322393370","17183900","144810095880"
"2021/07/21","42815251254","3082537520","105967444495","0","151865233269"
"2021/07/20","45742888057","3687022290","87091816360","0","136521726707"
"2021/07/19","38255420487","4699590450","76482718510","0","119437729447"
"2021/07/16","41267344419","3473940790","73117245750","0","117858530959"
"2021/07/15","105492797357","5000120050","101704551800","4307950","212201777157"
"2021/07/14","48637305903","3317988510","70306622580","17853900","122279770893"
"2021/07/13","45839849781","3562467090","85044094915","11337300","134457749086"
"2021/07/12","26060467285","2898587520","71199349130","3183600","100161587535"
"2021/07/09","41063872099","4712817500","93295800165","0","139072489764"
"2021/07/08","46215986059","2610718860","107210300520","0","156037005439"
"2021/07/07","37605330905","4264648210","79235632345","0","121105611460"
"2021/07/06","44402768745","1608300230","93049275100","0","139060344075"
"2021/07/05","14917252335","2802610600","63987256470","59898000","81767017405"
"2021/07/02","46598885564","5809421040","94665155030","0","147073461634"
"2021/07/01","33568752155","3892912490","85425133790","0","122886798435"
"2021/06/30","28950523110","2096963290","70923208280","0","101970694680"
"2021/06/29","59120395965","3218755240","78425611080","0","140764762285"
"2021/06/28","15104973560","2018362300","76967223045","0","94090558905"
"2021/06/25","20869102817","1900162450","76534190885","0","99303456152"
"2021/06/24","31912169930","2674261870","114606090170","16600600","149209122570"
"2021/06/23","41011903580","3217773470","97531496540","7474840","141768648430"
"2021/06/22","17463196430","2337863250","104228396390","0","124029456070"
"2021/06/21","35492059251","3252065310","92179908520","863000","130924896081"
"2021/06/18","26367187395","2216574100","78003693545","4020000","106591475040"
"2021/06/17","38229731910","2528989270","89295766275","10174200","130064661655"
"2021/06/16","14836835109","847246590","85779084865","0","101463166564"
"2021/06/15","33782655211","1850438560","93338169555","0","128971263326"
"2021/06/14","9827748253","3556903430","71063012375","13931500","84461595558"
"2021/06/11","39305285896","2221507690","113389989355","13230000","154930012941"
"2021/06/10","19784726165","2871804920","90791003735","15002400","113462537220"
"2021/06/09","9547664325","2520770600","96240261082","15355500","108324051507"
"2021/06/08","3500645170","1702893600","65757138680","6786000","70967463450"
"2021/06/07","2318481959","1381527320","72800282635","0","76500291914"
"2021/06/04","13740530677","1717173480","84530555050","0","99988259207"
"2021/06/03","8153538410","1287923950","79818039475","0","89259501835"
"2021/06/02","6622068459","1577081370","97625665765","0","105824815594"
"2021/06/01","8410238600","1299860920","68411480555","15071950","78136652025"
"2021/05/31","13095253940","1955176300","77175622125","4492800","92230545165"
"2021/05/28","15194056705","1046144460","93680654685","0","109920855850"
"2021/05/27","14005201685","1786611640","117455633340","0","133247446665"
"2021/05/26","9610101890","1392995095","56524766030","0","67527863015"
"2021/05/25","15342041270","1854923845","66222480835","0","83419445950"
"2021/05/24","19049933095","1300780450","71480586845","0","91831300390"
"2021/05/21","10124631048","2366404865","92490721870","14677000","104996434783"
"2021/05/20","13825523239","2761677215","77166033635","0","93753234089"
"2021/05/18","12182296225","4068213430","98114519140","16130570","114381159365"
"2021/05/17","24157706149","3153402930","104422113855","0","131733222934"
"2021/05/14","9306746396","3063851460","76711289405","0","89081887261"
"2021/05/13","13956998319","2450460970","88175961625","0","104583420914"
"2021/05/12","35516794067","3208029475","129452168945","0","168176992487"
"2021/05/11","18730412184","2094314710","131634220375","30751520","152489698789"
"2021/05/10","17859071903","2516936985","101144779295","0","121520788183"
"2021/05/07","9777512812","3162700670","110583497390","0","123523710872"
"2021/05/06","20084622336","2812912980","158463488520","0","181361023836"
"2021/05/04","25687148537","5554260080","144887060990","0","176128469607"
"2021/05/03","56541091093","5047323640","217930964865","0","279519379598"
"2021/04/30","1639660052","0","0","0","1639660052"
"2021/04/29","2965922268","0","0","0","2965922268"
"2021/04/28","2296881546","0","0","0","2296881546"
"2021/04/27","4026579384","0","0","0","4026579384"
"2021/04/26","3128117677","0","0","0","3128117677"
"2021/04/23","2631820184","0","0","0","2631820184"
"2021/04/22","2437566072","0","0","0","2437566072"
"2021/04/21","4119579341","0","0","0","4119579341"
"2021/04/20","1570737723","0","0","0","1570737723"
"2021/04/19","3181299301","0","0","0","3181299301"
"2021/04/16","1601109258","0","0","0","1601109258"
"2021/04/15","1534598946","0","0","0","1534598946"
"2021/04/14","3330621114","0","0","0","3330621114"
"2021/04/13","4039615383","0","0","0","4039615383"
"2021/04/12","5182484484","0","0","0","5182484484"
"2021/04/09","2506389864","0","0","0","2506389864"
"2021/04/08","6235701517","0","0","0","6235701517"
"2021/04/07","2601904349","0","0","0","2601904349"
"2021/04/06","1382921733","0","0","0","1382921733"
"2021/04/05","2359803020","0","0","0","2359803020"
"2021/04/02","2858772090","0","0","0","2858772090"
"2021/04/01","2574164324","0","0","0","2574164324"
"2021/03/31","2075309063","0","0","0","2075309063"
"2021/03/30","1574584856","0","0","0","1574584856"
"2021/03/29","1649603290","0","0","0","1649603290"
"2021/03/26","1335555404","0","0","0","1335555404"
"2021/03/25","1346793912","0","0","0","1346793912"
"2021/03/24","3213051156","0","0","0","3213051156"
"2021/03/23","1856358663","0","0","0","1856358663"
"2021/03/22","1373806427","0","0","0","1373806427"
"2021/03/19","3335184141","0","0","0","3335184141"
"2021/03/18","1953258975","0","0","0","1953258975"
"2021/03/17","2575676380","0","0","0","2575676380"
"2021/03/16","2099146697","0","0","0","2099146697"
"2021/03/15","1608701918","0","0","0","1608701918"
"2021/03/12","1280220336","0","0","0","1280220336"
"2021/03/11","1069098118","0","0","0","1069098118"
"2021/03/10","1104995807","0","0","0","1104995807"
"2021/03/09","4419131834","0","0","0","4419131834"
"2021/03/08","285446975","0","0","0","285446975"
"2021/03/05","3275638456","0","0","0","3275638456"
"2021/03/04","5618850958","0","0","0","5618850958"
"2021/03/03","2903501225","0","0","0","2903501225"
"2021/03/02","1786231695","0","0","0","1786231695"
"2021/02/26","2066754415","0","0","0","2066754415"
"2021/02/25","4581083438","0","0","0","4581083438"
"2021/02/24","1848737591","0","0","0","1848737591"
"2021/02/23","1033789058","0","0","0","1033789058"
"2021/02/22","2444851890","0","0","0","2444851890"
"2021/02/19","1719616792","0","0","0","1719616792"
"2021/02/18","1675626713","0","0","0","1675626713"
"2021/02/17","1362859734","0","0","0","1362859734"
"2021/02/16","775037696","0","0","0","775037696"
"2021/02/15","4676916309","0","0","0","4676916309"
"2021/02/10","740951661","0","0","0","740951661"
"2021/02/09","1027201115","0","0","0","1027201115"
"2021/02/08","1731844250","0","0","0","1731844250"
"2021/02/05","1421569590","0","0","0","1421569590"
"2021/02/04","1335815230","0","0","0","1335815230"
"2021/02/03","2068997839","0","0","0","2068997839"
"2021/02/02","2534137680","0","0","0","2534137680"
"2021/02/01","1684245041","0","0","0","1684245041"
"2021/01/29","1390443641","0","0","0","1390443641"
"2021/01/28","767518769","0","0","0","767518769"
"2021/01/27","1225244727","0","0","0","1225244727"
"2021/01/26","984969796","0","0","0","984969796"
"2021/01/25","825392353","0","0","0","825392353"
"2021/01/22","3285228735","0","0","0","3285228735"
"2021/01/21","1417904109","0","0","0","1417904109"
"2021/01/20","3117862631","0","0","0","3117862631"
"2021/01/19","2981160792","0","0","0","2981160792"
"2021/01/18","2908232137","0","0","0","2908232137"
"2021/01/15","3052300298","0","0","0","3052300298"
"2021/01/14","4691914017","0","0","0","4691914017"
"2021/01/13","3014737231","0","0","0","3014737231"
"2021/01/12","1985240553","0","0","0","1985240553"
"2021/01/11","4141288765","0","0","0","4141288765"
"2021/01/08","2552581359","0","0","0","2552581359"
"2021/01/07","2243141551","0","0","0","2243141551"
"2021/01/06","1378114484","0","0","0","1378114484"
"2021/01/05","2515010711","0","0","0","2515010711"
"2021/01/04","7067302914","0","0","0","7067302914"
"2020/12/30","5511999040","0","0","0","5511999040"
"2020/12/29","3223516120","0","0","0","3223516120"
"2020/12/28","2177468041","0","0","0","2177468041"
"2020/12/24","2076649979","0","0","0","2076649979"
"2020/12/23","1874535530","0","0","0","1874535530"
"2020/12/22","1242146727","0","0","0","1242146727"
"2020/12/21","2878482365","0","0","0","2878482365"
"2020/12/18","1854194574","0","0","0","1854194574"
"2020/12/17","3496578710","0","0","0","3496578710"
"2020/12/16","7154366857","0","0","0","7154366857"
"2020/12/15","3052845924","0","0","0","3052845924"
"2020/12/14","5107212840","0","0","0","5107212840"
"2020/12/11","4493209573","0","0","0","4493209573"
"2020/12/10","30029547479","0","0","0","30029547479"
"2020/12/09","3707455697","0","0","0","3707455697"
"2020/12/08","1339551084","0","0","0","1339551084"
"2020/12/07","3119847211","0","0","0","3119847211"
"2020/12/04","3095527878","0","0","0","3095527878"
"2020/12/03","4617359741","0","0","0","4617359741"
"2020/12/02","1854306686","0","0","0","1854306686"
"2020/12/01","1136959062","0","0","0","1136959062"
"2020/11/30","3319581985","0","0","0","3319581985"
"2020/11/27","2356140562","0","0","0","2356140562"
"2020/11/26","2011499903","0","0","0","2011499903"
"2020/11/25","1884469696","0","0","0","1884469696"
"2020/11/24","4988459730","0","0","0","4988459730"
"2020/11/23","1572866234","0","0","0","1572866234"
"2020/11/20","1650732655","0","0","0","1650732655"
"2020/11/19","2112076332","0","0","0","2112076332"
"2020/11/18","2783445788","0","0","0","2783445788"
"2020/11/17","3355253546","0","0","0","3355253546"
"2020/11/16","2046765275","0","0","0","2046765275"
"2020/11/13","2992339745","0","0","0","2992339745"
"2020/11/12","3905207787","0","0","0","3905207787"
"2020/11/11","3287612607","0","0","0","3287612607"
"2020/11/10","2595939295","0","0","0","2595939295"
"2020/11/09","2190027225","0","0","0","2190027225"
"2020/11/06","2446737383","0","0","0","2446737383"
"2020/11/05","2292460204","0","0","0","2292460204"
"2020/11/04","1907788248","0","0","0","1907788248"
"2020/11/03","1609132927","0","0","0","1609132927"
"2020/11/02","528889273","0","0","0","528889273"
"2020/10/30","1008386069","0","0","0","1008386069"
"2020/10/29","1236756512","0","0","0","1236756512"
"2020/10/28","1782448764","0","0","0","1782448764"
"2020/10/27","2947816492","0","0","0","2947816492"
"2020/10/26","2985451782","0","0","0","2985451782"
"2020/10/23","2314999965","0","0","0","2314999965"
"2020/10/22","1638772209","0","0","0","1638772209"
"2020/10/21","1966645844","0","0","0","1966645844"
"2020/10/20","4670307484","0","0","0","4670307484"
"2020/10/19","2313350357","0","0","0","2313350357"
"2020/10/16","2731054894","0","0","0","2731054894"
"2020/10/15","3712814517","0","0","0","3712814517"
"2020/10/14","2819050590","0","0","0","2819050590"
"2020/10/13","2445663272","0","0","0","2445663272"
"2020/10/12","3950689119","0","0","0","3950689119"
"2020/10/08","3792678870","0","0","0","3792678870"
"2020/10/07","2771091477","0","0","0","2771091477"
"2020/10/06","1942898832","0","0","0","1942898832"
"2020/10/05","3197958383","0","0","0","3197958383"
"2020/09/29","2314256412","0","0","0","2314256412"
"2020/09/28","3127616979","0","0","0","3127616979"
"2020/09/25","1767858274","0","0","0","1767858274"
"2020/09/24","2638160051","0","0","0","2638160051"
"2020/09/23","2240419991","0","0","0","2240419991"
"2020/09/22","3383056354","0","0","0","3383056354"
"2020/09/21","2870834428","0","0","0","2870834428"
"2020/09/18","4894662510","0","0","0","4894662510"
"2020/09/17","2763351416","0","0","0","2763351416"
"2020/09/16","8254198657","0","0","0","8254198657"
"2020/09/15","4783952416","0","0","0","4783952416"
"2020/09/14","2581347614","0","0","0","2581347614"
"2020/09/11","5726799675","0","0","0","5726799675"
"2020/09/10","9064158089","0","0","0","9064158089"
"2020/09/09","5102421671","0","0","0","5102421671"
"2020/09/08","4751189606","0","0","0","4751189606"
"2020/09/07","3064113024","0","0","0","3064113024"
"2020/09/04","2918113735","0","0","0","2918113735"
"2020/09/03","3534231194","0","0","0","3534231194"
"2020/09/02","2664225007","0","0","0","2664225007"
"2020/09/01","3166104480","0","0","0","3166104480"
"2020/08/31","8220897020","0","0","0","8220897020"
"2020/08/28","3045212712","0","0","0","3045212712"
"2020/08/27","3964389085","0","0","0","3964389085"
"2020/08/26","3858841376","0","0","0","3858841376"
"2020/08/25","5011619241","0","0","0","5011619241"
"2020/08/24","4546516872","0","0","0","4546516872"
"2020/08/21","4762699122","0","0","0","4762699122"
"2020/08/20","7476423663","0","0","0","7476423663"
"2020/08/19","10888908202","0","0","0","10888908202"
"2020/08/18","9598869519","0","0","0","9598869519"
"2020/08/14","7721780456","0","0","0","7721780456"
"2020/08/13","4506517117","0","0","0","4506517117"
"2020/08/12","4009567515","0","0","0","4009567515"
"2020/08/11","7735249707","0","0","0","7735249707"
"2020/08/10","2842544185","0","0","0","2842544185"
"2020/08/07","5078752775","0","0","0","5078752775"
"2020/08/06","4922282971","0","0","0","4922282971"
"2020/08/05","2629448015","0","0","0","2629448015"
"2020/08/04","9497968559","0","0","0","9497968559"
"2020/08/03","10268142460","0","0","0","10268142460"
"2020/07/31","5124835765","0","0","0","5124835765"
"2020/07/30","8705765543","0","0","0","8705765543"
"2020/07/29","8341866565","0","0","0","8341866565"
"2020/07/28","3084976212","0","0","0","3084976212"
"2020/07/27","4414871784","0","0","0","4414871784"
"2020/07/24","3947995021","0","0","0","3947995021"
"2020/07/23","10844581202","0","0","0","10844581202"
"2020/07/22","4155708446","0","0","0","4155708446"
"2020/07/21","3426786235","0","0","0","3426786235"
"2020/07/20","5066904035","0","0","0","5066904035"
"2020/07/17","3791872316","0","0","0","3791872316"
"2020/07/16","5271346839","0","0","0","5271346839"
"2020/07/15","4156811631","0","0","0","4156811631"
"2020/07/14","2659879770","0","0","0","2659879770"
"2020/07/13","4906652766","0","0","0","4906652766"
"2020/07/10","16758318177","0","0","0","16758318177"
"2020/07/09","9834171135","0","0","0","9834171135"
"2020/07/08","9800780335","0","0","0","9800780335"
"2020/07/07","6009071742","0","0","0","6009071742"
"2020/07/06","4140616453","0","0","0","4140616453"
"2020/07/03","5716413068","0","0","0","5716413068"
"2020/07/02","4409482655","0","0","0","4409482655"
"2020/07/01","1953672817","0","0","0","1953672817"
"2020/06/30","5783296458","0","0","0","5783296458"
"2020/06/29","4976250494","0","0","0","4976250494"
"2020/06/26","2164720997","0","0","0","2164720997"
"2020/06/25","3777105562","0","0","0","3777105562"
"2020/06/24","2577543194","0","0","0","2577543194"
"2020/06/23","5147677919","0","0","0","5147677919"
"2020/06/22","2201965022","0","0","0","2201965022"
"2020/06/19","2377983999","0","0","0","2377983999"
"2020/06/18","2568949325","0","0","0","2568949325"
"2020/06/17","2953442486","0","0","0","2953442486"
"2020/06/16","2663311555","0","0","0","2663311555"
"2020/06/15","1242822082","0","0","0","1242822082"
"2020/06/12","5353422312","0","0","0","5353422312"
"2020/06/11","8124468954","0","0","0","8124468954"
"2020/06/10","1159479544","0","0","0","1159479544"
"2020/06/09","1281953435","0","0","0","1281953435"
"2020/06/08","1954521230","0","0","0","1954521230"
"2020/06/05","824934299","0","0","0","824934299"
"2020/06/04","1851912215","0","0","0","1851912215"
"2020/06/03","2648998954","0","0","0","2648998954"
"2020/06/02","2803865934","0","0","0","2803865934"
"2020/06/01","2267938348","0","0","0","2267938348"
"2020/05/29","3918637852","0","0","0","3918637852"
"2020/05/28","2754135452","0","0","0","2754135452"
"2020/05/27","2410889028","0","0","0","2410889028"
"2020/05/26","2006055954","0","0","0","2006055954"
"2020/05/25","1057152929","0","0","0","1057152929"
"2020/05/22","2510092816","0","0","0","2510092816"
"2020/05/21","1805142278","0","0","0","1805142278"
"2020/05/20","2239287773","0","0","0","2239287773"
"2020/05/19","3322455888","0","0","0","3322455888"
"2020/05/18","2492706456","0","0","0","2492706456"
"2020/05/15","4524144523","0","0","0","4524144523"
"2020/05/14","5730765967","0","0","0","5730765967"
"2020/05/13","1871818031","0","0","0","1871818031"
"2020/05/12","2694397818","0","0","0","2694397818"
"2020/05/11","1825768219","0","0","0","1825768219"
"2020/05/08","3076231297","0","0","0","3076231297"
"2020/05/07","470756608","0","0","0","470756608"
"2020/05/06","1245835151","0","0","0","1245835151"
"2020/05/04","812473854","0","0","0","812473854"
"2020/04/29","3126556929","0","0","0","3126556929"
"2020/04/28","1536825244","0","0","0","1536825244"
"2020/04/27","1033153545","0","0","0","1033153545"
"2020/04/24","1680724860","0","0","0","1680724860"
"2020/04/23","753597769","0","0","0","753597769"
"2020/04/22","4691049079","0","0","0","4691049079"
"2020/04/21","2298116342","0","0","0","2298116342"
"2020/04/20","3057660578","0","0","0","3057660578"
"2020/04/17","994318215","0","0","0","994318215"
"2020/04/16","2112491811","0","0","0","2112491811"
"2020/04/14","2463239714","0","0","0","2463239714"
"2020/04/13","4382062090","0","0","0","4382062090"
"2020/04/10","2938062348","0","0","0","2938062348"
"2020/04/09","2663044955","0","0","0","2663044955"
"2020/04/08","4219248448","0","0","0","4219248448"
"2020/04/07","3184331258","0","0","0","3184331258"
"2020/04/06","1827849310","0","0","0","1827849310"
"2020/04/03","4794479327","0","0","0","4794479327"
"2020/04/02","2304175660","0","0","0","2304175660"
"2020/04/01","6940297553","0","0","0","6940297553"
"2020/03/31","10719541801","0","0","0","10719541801"
"2020/03/30","7286174272","0","0","0","7286174272"
"2020/03/27","12896834812","0","0","0","12896834812"
"2020/03/26","5904452658","0","0","0","5904452658"
"2020/03/25","7508293894","0","0","0","7508293894"
"2020/03/24","5058094541","0","0","0","5058094541"
"2020/03/23","5208066980","0","0","0","5208066980"
"2020/03/20","1244113979","0","0","0","1244113979"
"2020/03/19","3342661518","0","0","0","3342661518"
"2020/03/18","3561032830","0","0","0","3561032830"
"2020/03/17","10187711412","0","0","0","10187711412"
"2020/03/16","27724198659","0","0","0","27724198659"
"2020/03/13","52037420871","5291459767","135225280778","51170000","192605331416"
"2020/03/12","47492757015","4362490040","161326476208","0","213181723263"
"2020/03/11","27105247671","3679717741","156384791450","73420000","187243176862"
"2020/03/10","46202738925","8052910156","139979969292","0","194235618373"
"2020/03/09","40801597954","4336111280","141161615873","0","186299325107"
"2020/03/06","43085090271","5258496465","130478616764","0","178822203500"
"2020/03/05","34762813076","3913102533","125947167677","0","164623083286"
"2020/03/04","26632278977","2815186604","100299277408","0","129746742989"
"2020/03/03","38570542813","3218361720","123132293442","266000000","165187197975"
"2020/03/02","39400646982","3690945816","109337116853","0","152428709651"
"2020/02/28","33858116817","3945025444","169050337773","0","206853480034"
"2020/02/27","48176924492","4142454277","174216294250","16500000","226552173019"
"2020/02/26","32721632759","3500138989","109852477388","0","146074249136"
"2020/02/25","24417131573","3341409797","119751452046","0","147509993416"
"2020/02/24","33630430813","4302098745","149858014607","0","187790544165"
"2020/02/21","24365198518","2304240170","105441703712","0","132111142400"
"2020/02/20","34334422463","4682621610","111579460455","0","150596504528"
"2020/02/19","46808903431","5365451770","105959310699","0","158133665900"
"2020/02/18","55573842366","3899325305","122864780710","0","182337948381"
"2020/02/17","25361504145","2773161172","117967833757","0","146102499074"
"2020/02/14","38199439147","3890503875","128922422205","0","171012365227"
"2020/02/13","51209473211","3244152543","112619490232","0","167073115986"
"2020/02/12","18599249540","2271236281","130633960598","0","151504446419"
"2020/02/11","27071980757","4399198682","96647269449","8600000","128127048888"
"2020/02/10","29289456354","3280719678","75069951325","0","107640127357"
"2020/02/07","32211741416","3096205755","105373575460","140000000","140821522631"
"2020/02/06","29899578566","2524067370","86472280867","0","118895926803"
"2020/02/05","39536336151","3605456563","95422056360","0","138563849074"
"2020/02/04","53409910358","3826778585","99233578417","0","156470267360"
"2020/02/03","28903139502","4780349847","111351381290","0","145034870639"
"2020/01/31","28167455653","2832509726","111495052816","0","142495018195"
"2020/01/30","45768455702","3649266861","143405227737","0","192822950300"
"2020/01/29","26458023167","3459858080","118982722424","0","148900603671"
"2020/01/28","45471673336","4218923460","142761036145","0","192451632941"
"2020/01/23","26245185285","2051278280","91861893847","0","120158357412"
"2020/01/22","28533019322","5214885768","84176411760","0","117924316850"
"2020/01/21","30995903708","2262516518","92620104877","0","125878525103"
"2020/01/20","43314206436","2147974810","94740139928","0","140202321174"
"2020/01/17","35654208805","2553645364","77154555568","0","115362409737"
"2020/01/16","66264988280","4956183714","111850690014","31200000","183103062008"
"2020/01/15","31127706024","2618295717","82280801408","0","116026803149"
"2020/01/14","34131856714","3877491065","114331852309","0","152341200088"
"2020/01/13","32624035515","4868278850","101045268385","0","138537582750"
"2020/01/10","35324259223","6720639645","92213771717","0","134258670585"
"2020/01/09","31069183231","3332906267","89329612461","0","123731701959"
"2020/01/08","27797122175","3168638435","117989930213","0","148955690823"
"2020/01/07","28499167529","3124315602","99376107644","0","130999590775"
"2020/01/06","44502179996","3242173416","99497698005","0","147242051417"
"2020/01/03","50768923489","4641674370","126625629757","0","182036227616"
"2020/01/02","32828000975","4473468866","87121854908","0","124423324749"